HTC Mayhem - Hearthstone Hotseat	Video:hHzmCDPtiZk	Channel:UCcLgWeVW3Z_ZWCYURqfgvaQ
HTC Mayhem - Expansion Draft & Interviews	Video:KnWufEN-alM	Channel:UCcLgWeVW3Z_ZWCYURqfgvaQ
HTC Mayhem - Categories	Video:E-w1JuH6B-I	Channel:UCcLgWeVW3Z_ZWCYURqfgvaQ
HTC Mayhem - 15 15 Gameplay	Video:DXOi2ap7H6E	Channel:UCcLgWeVW3Z_ZWCYURqfgvaQ
HTC Mayhem - 15 15 Draft	Video:GdhgOfaCdaI	Channel:UCcLgWeVW3Z_ZWCYURqfgvaQ
HTC Mayhem  - Heroic Adventure Marathon	Video:FUaZD210WjM	Channel:UCcLgWeVW3Z_ZWCYURqfgvaQ
HTC Mayhem - Blind Pick Conquest	Video:IBCExonY3rM	Channel:UCcLgWeVW3Z_ZWCYURqfgvaQ
HTC Mayhem - Trailer - A Hearthstone Sabotage Tournament	Video:EGBZkTgYYAI	Channel:UCcLgWeVW3Z_ZWCYURqfgvaQ
Team Liquid CS:GO | Vanguard - ESL Pro League Season 4	Video:_hpBbLHG2nc	Channel:UCcLgWeVW3Z_ZWCYURqfgvaQ
Team Liquid | Breaking Point	Video:eIzGXt--Ig4	Channel:UCcLgWeVW3Z_ZWCYURqfgvaQ
Team Liquid | Breaking Point - Media Trailer	Video:pqHrt1-ktnM	Channel:UCcLgWeVW3Z_ZWCYURqfgvaQ
Team Liquid CS:GO | Vanguard - ESL One New York	Video:hFJls15la4M	Channel:UCcLgWeVW3Z_ZWCYURqfgvaQ
Team Liquid | Breaking Point - Trailer	Video:iTELFDdnTEw	Channel:UCcLgWeVW3Z_ZWCYURqfgvaQ
HTC | Talk Worlds with Doublelift & Sneaky	Video:29N1dttNjnU	Channel:UCcLgWeVW3Z_ZWCYURqfgvaQ
HTC Vive | TLGO + Keep Talking & Nobody Explodes	Video:PHCxQpfS23w	Channel:UCcLgWeVW3Z_ZWCYURqfgvaQ
Team Liquid Dota 2 | Player Profile - KuroKy	Video:xRhjOfguzWQ	Channel:UCcLgWeVW3Z_ZWCYURqfgvaQ
Team Liquid CS:GO | Vanguard - ESL Cologne	Video:mNWLXcn_S6U	Channel:UCcLgWeVW3Z_ZWCYURqfgvaQ
Team Liquid Dota 2 | Player Profile - MATUMBAMAN	Video:sa-pgEqTf_I	Channel:UCcLgWeVW3Z_ZWCYURqfgvaQ
Team Liquid | Rebirth - The Movie - Trailer	Video:QXxP6SuTdM0	Channel:UCcLgWeVW3Z_ZWCYURqfgvaQ
Cloud9 Training Arc: n0thing (FINALE)	Video:rh10MMuTSr0	Channel:UCcLgWeVW3Z_ZWCYURqfgvaQ
Cloud9 Training Arc: Skadoodle	Video:5RbBTFEB64g	Channel:UCcLgWeVW3Z_ZWCYURqfgvaQ
Is Biofrost Worthy?	Video:TogJRw3C6DU	Channel:UCcLgWeVW3Z_ZWCYURqfgvaQ
Cloud9 Training Arc: Stewie	Video:wIXWkvv4iSc	Channel:UCcLgWeVW3Z_ZWCYURqfgvaQ
Cloud9 Training Arc: Shroud	Video:qF7k5wUYhBA	Channel:UCcLgWeVW3Z_ZWCYURqfgvaQ
Cloud9 Training Arc: Slemmy	Video:gu7S_gPrvOQ	Channel:UCcLgWeVW3Z_ZWCYURqfgvaQ
Cloud9 Training Arc: Prologue	Video:9ziO33778AE	Channel:UCcLgWeVW3Z_ZWCYURqfgvaQ
Team Liquid LoL | Dabby	Video:dsAi6OnO2tU	Channel:UCcLgWeVW3Z_ZWCYURqfgvaQ
Team Liquid CS:GO | Vanguard - ECS Season 1	Video:WxP6lSERXQk	Channel:UCcLgWeVW3Z_ZWCYURqfgvaQ
Hai the Shot Caller	Video:wZeX0_S-ikE	Channel:UCcLgWeVW3Z_ZWCYURqfgvaQ
Quest for the GOAT	Video:4GZsYJFx-zA	Channel:UCcLgWeVW3Z_ZWCYURqfgvaQ
Team Liquid CS:GO | Dreamhack Austin Vlog	Video:bXoGYxMfhHo	Channel:UCcLgWeVW3Z_ZWCYURqfgvaQ
Team Liquid | Rebirth - The Final Episode	Video:fuOTQiIlNM4	Channel:UCcLgWeVW3Z_ZWCYURqfgvaQ
Team Liquid CS:GO | Vlog - Hiko & Loco Talk LA Bootcamp	Video:AqBMnigQeYw	Channel:UCcLgWeVW3Z_ZWCYURqfgvaQ
Team Liquid CS:GO | Vanguard - MLG Columbus	Video:z3Cfuhe5AJk	Channel:UCcLgWeVW3Z_ZWCYURqfgvaQ
HTC Vive Art w/ ffSade and ohnips	Video:5p0eO648Ra0	Channel:UCcLgWeVW3Z_ZWCYURqfgvaQ
Team Liquid | Rebirth EP22 - Forever	Video:c_4bD6igA-E	Channel:UCcLgWeVW3Z_ZWCYURqfgvaQ
Team Liquid | Rebirth EP21 - Dreamcatcher	Video:tMLg11i1uVM	Channel:UCcLgWeVW3Z_ZWCYURqfgvaQ
Retirement Home	Video:kNZF3pxWQcI	Channel:UCcLgWeVW3Z_ZWCYURqfgvaQ
Team Liquid | Rebirth EP20 - Awakening	Video:zbM-3WILF2Y	Channel:UCcLgWeVW3Z_ZWCYURqfgvaQ
HTC Vive - Get Vive Ready (behind the scenes) feat. xPeke, Cyanide, TLO & Leffen	Video:HFSHoCwCRpA	Channel:UCcLgWeVW3Z_ZWCYURqfgvaQ
HTC Vive - Super Challenger (Get Vive Ready Street Tests)	Video:QeMJqylbJwk	Channel:UCcLgWeVW3Z_ZWCYURqfgvaQ
HTC Vive - Rat Trap (Get Vive Ready Street Tests)	Video:WTgao3kSdFY	Channel:UCcLgWeVW3Z_ZWCYURqfgvaQ
HTC Vive - Paddle Pass (Get Vive Ready Street Tests)	Video:e0nmAmHd7JE	Channel:UCcLgWeVW3Z_ZWCYURqfgvaQ
HTC Vive - LEGENDS MELEE feat. xPeke, Cyanide, TLO & Leffen (Get Vive Ready Street Tests)	Video:-LEIw21KqvE	Channel:UCcLgWeVW3Z_ZWCYURqfgvaQ
HTC Vive - Gorilla Stairs (Get Vive Ready Street Tests)	Video:jYDg7tx7FiA	Channel:UCcLgWeVW3Z_ZWCYURqfgvaQ
HTC Vive - Duck & Dive (Get Vive Ready Street Tests)	Video:2EzaH8fKGNI	Channel:UCcLgWeVW3Z_ZWCYURqfgvaQ
HTC Vive - Sweet Squeeze (Get Vive Ready Street Tests)	Video:2vfkcFbYecI	Channel:UCcLgWeVW3Z_ZWCYURqfgvaQ
HTC Vive - CHARGEDOWN (Get Vive Ready Street Tests)	Video:tojV6a__zZw	Channel:UCcLgWeVW3Z_ZWCYURqfgvaQ
Liquid | Rebirth EP19 - Toil	Video:ZQi3pyW9jGw	Channel:UCcLgWeVW3Z_ZWCYURqfgvaQ
Liquid | Rebirth EP18 - Captain	Video:NHiJgLr844s	Channel:UCcLgWeVW3Z_ZWCYURqfgvaQ
Liquid | Rebirth EP17 - TLOP	Video:zcangCJrbSI	Channel:UCcLgWeVW3Z_ZWCYURqfgvaQ
Liquid | Rebirth EP16 - Progress	Video:2NCpavNnef0	Channel:UCcLgWeVW3Z_ZWCYURqfgvaQ
Have you Tried the Vive Yet? (feat. HugS & SFAT)	Video:lFR9PDJNy9I	Channel:UCcLgWeVW3Z_ZWCYURqfgvaQ
HTC Esports - We're Just Getting Started	Video:6a_4LS4I_og	Channel:UCcLgWeVW3Z_ZWCYURqfgvaQ
Liquid | Rebirth EP15 - Waves	Video:7eu-4EcfIio	Channel:UCcLgWeVW3Z_ZWCYURqfgvaQ
Liquid | Rebirth EP14 - Squad	Video:6yKawMOtj6c	Channel:UCcLgWeVW3Z_ZWCYURqfgvaQ
Team Liquid | Vlog 07 - Meet Team Liquid's New Top Laner Lourlo	Video:lc9UPF9IrZI	Channel:UCcLgWeVW3Z_ZWCYURqfgvaQ
Liquid | Rebirth Season 3 - Teaser	Video:MiUow_jVBNA	Channel:UCcLgWeVW3Z_ZWCYURqfgvaQ
HTC Rivals | Vol. 3: Triumph	Video:l2ay2_5A2ko	Channel:UCcLgWeVW3Z_ZWCYURqfgvaQ
Team Liquid Hearthstone | Savjz Guide - Road to Legend	Video:QpuLwWdphZQ	Channel:UCcLgWeVW3Z_ZWCYURqfgvaQ
TSM - Doublelift's Search for his Star	Video:jdTdgOMhjYY	Channel:UCcLgWeVW3Z_ZWCYURqfgvaQ
HTC Ascension Feature | Liquid Piglet - TLA	Video:6Xim9p5wSu0	Channel:UCcLgWeVW3Z_ZWCYURqfgvaQ
HTC Ascension Feature | Liquid Piglet - Challenger	Video:C4T67Ttj2yM	Channel:UCcLgWeVW3Z_ZWCYURqfgvaQ
Team Liquid LoL | Vlog 06 - Liquid112 Holiday Update on LoL Team	Video:bjQXA7G-fEc	Channel:UCcLgWeVW3Z_ZWCYURqfgvaQ
HTC Ascension Feature | TLA Youngbin	Video:pZfn401LlU8	Channel:UCcLgWeVW3Z_ZWCYURqfgvaQ
HTC Ascension | Playoffs Hype	Video:ReouW_iETDY	Channel:UCcLgWeVW3Z_ZWCYURqfgvaQ
HTC Ascension Feature | Zenith's Mango	Video:tnQpKQ3lY60	Channel:UCcLgWeVW3Z_ZWCYURqfgvaQ
HTC Ascension Top 5 Plays - Week 2	Video:IyagEZe6jj4	Channel:UCcLgWeVW3Z_ZWCYURqfgvaQ
HTC Rivals | Vol. 2: Stamina	Video:OTOtXx_a0qk	Channel:UCcLgWeVW3Z_ZWCYURqfgvaQ
HTC Ascension Feature: TLA Matt	Video:mpDbERwFiRA	Channel:UCcLgWeVW3Z_ZWCYURqfgvaQ
HTC Ascension Feature: Team Liquid's Steve Arhancet	Video:ObAbOCh9Vgg	Channel:UCcLgWeVW3Z_ZWCYURqfgvaQ
HTC Ascension Top 5 Plays - Week 1	Video:J240HsgM7f0	Channel:UCcLgWeVW3Z_ZWCYURqfgvaQ
HTC Ascension Feature: TLA Dardoch	Video:5-m7iQTXv-s	Channel:UCcLgWeVW3Z_ZWCYURqfgvaQ
Team Liquid SC2 | Snute Vlog - Blizzcon and the Future	Video:yxJYOppO99o	Channel:UCcLgWeVW3Z_ZWCYURqfgvaQ
Team Liquid SC2 | MaNa Vlog - Past and Future	Video:hpVCsasd2HM	Channel:UCcLgWeVW3Z_ZWCYURqfgvaQ
HTC Ascension Trailer	Video:6qsiMy6IEv8	Channel:UCcLgWeVW3Z_ZWCYURqfgvaQ
Team Liquid LoL | Vlog 05 - Piglet Shows Off His English with Joka	Video:KkJkgeHjPRs	Channel:UCcLgWeVW3Z_ZWCYURqfgvaQ
Team Liquid LoL | Vlog 04 - HTC Ascension and Bloopers	Video:Ttadh7_cHWQ	Channel:UCcLgWeVW3Z_ZWCYURqfgvaQ
HTC Rivals | Vol. 1: Origins - Super Smash Bros.	Video:rGAxjClHTpM	Channel:UCcLgWeVW3Z_ZWCYURqfgvaQ
DreamHack Cluj-Napoca Hype Video	Video:91sx75MHFaE	Channel:UCcLgWeVW3Z_ZWCYURqfgvaQ
HTC Rivals | Teaser Trailer - Super Smash Bros.	Video:_LkWy6y4wJA	Channel:UCcLgWeVW3Z_ZWCYURqfgvaQ
Grand Finals - Cloud9 vs Murloc Geniuses | HTC Heroes Brawl | 10-18-2015	Video:8ZH5NGOqo68	Channel:UCcLgWeVW3Z_ZWCYURqfgvaQ
HTC Vive at HTC Throwdown Smash	Video:FFWZfY8jIQk	Channel:UCcLgWeVW3Z_ZWCYURqfgvaQ
HTC Throwdown - R2 Bracket: ycz6 (Samus) vs Liquid`Ken (Marth)	Video:pQUnqf7z_qc	Channel:UCcLgWeVW3Z_ZWCYURqfgvaQ
HTC Throwdown - Bracket Pools: SFAT (Fox) vs Yamz (Luigi)	Video:wxGctKGNGJE	Channel:UCcLgWeVW3Z_ZWCYURqfgvaQ
HTC Throwdown - Top 8 - Grand Finals: Liquid`Hungrybox (Puff) vs TSM|Leffen (Fox)	Video:1dJkJblpJHg	Channel:UCcLgWeVW3Z_ZWCYURqfgvaQ
HTC Throwdown - Top 8 - Loser Finals: GC|Silent Wolf (Fox) vs Liquid`Hungrybox (Puff)	Video:Rm9BvSBLPKs	Channel:UCcLgWeVW3Z_ZWCYURqfgvaQ
HTC Throwdown - Top 8 - Loser Semis: GC|Silent Wolf (Fox) vs Druggedfox (Sheik)	Video:jDBFJsj67jo	Channel:UCcLgWeVW3Z_ZWCYURqfgvaQ
HTC Throwdown - Top 8 - Winner Finals: Liquid`Hungrybox (Puff) vs TSM|Leffen (Fox)	Video:BLeQcobhcBo	Channel:UCcLgWeVW3Z_ZWCYURqfgvaQ
HTC Throwdown - Top 8 - Loser Quarters: SS|Colbol (Fox) vs Druggedfox (Sheik)	Video:E_8PnU3EtlA	Channel:UCcLgWeVW3Z_ZWCYURqfgvaQ
HTC Throwdown - Teams - Grand Finals 2: Liquid`Hungrybox & COG MVG|Mew2King vs TSM|Leffen & FE|MacD	Video:WpBMSvBLyGI	Channel:UCcLgWeVW3Z_ZWCYURqfgvaQ
HTC Throwdown - Teams - Grand Finals: Liquid`Hungrybox & COG MVG|Mew2King vs TSM|Leffen & FE|MacD	Video:TLem3l7oIwo	Channel:UCcLgWeVW3Z_ZWCYURqfgvaQ
HTC Throwdown - Teams - Loser Finals: CLG.PewPewU & SFAT vs TSM|Leffen & FE|MacD	Video:3URxRl3M2vI	Channel:UCcLgWeVW3Z_ZWCYURqfgvaQ
HTC Throwdown - Top 8 - Loser Quarters: COG MVG|Mew2King (Sheik) vs GC|Silent Wolf (Fox)	Video:7SQGp4hvWxg	Channel:UCcLgWeVW3Z_ZWCYURqfgvaQ
HTC Throwdown - R2 Bracket - LR4: FE|MacD (Peach) vs PG|Plup (Sheik)	Video:8Pz9c08NL4Y	Channel:UCcLgWeVW3Z_ZWCYURqfgvaQ
HTC Throwdown - Final Bracket - LR1: SFAT (Fox) vs Druggedfox (Sheik/Marth)	Video:OUuanW6fNJ4	Channel:UCcLgWeVW3Z_ZWCYURqfgvaQ
HTC Throwdown - Top 8 - Winner Semis: GC|Silent Wolf (Fox) vs TSM|Leffen (Fox)	Video:PpnQXiBrHc8	Channel:UCcLgWeVW3Z_ZWCYURqfgvaQ
HTC Throwdown - Top 8 - Winner Semis: SS|Colbol (Fox) vs Liquid`Hungrybox (Puff)	Video:Elhuj1bMviE	Channel:UCcLgWeVW3Z_ZWCYURqfgvaQ
HTC Throwdown - Top 8 - Loser Quarters: COG|Mew2King (Sheik) vs WFX|Shroomed (Sheik)	Video:mDCAGgkoUJk	Channel:UCcLgWeVW3Z_ZWCYURqfgvaQ
HTC Throwdown - Teams - Winner Finals: CLG.PewPewU & SFAT vs COG MVG|Mew2King & Liquid`HungryBox	Video:1rYbA4CyLRo	Channel:UCcLgWeVW3Z_ZWCYURqfgvaQ
HTC Throwdown - Teams - Loser Quarters: TSM|Leffen & FE|MacD vs DruggedFox & SS|Colbol	Video:Kt3z_jPBCPI	Channel:UCcLgWeVW3Z_ZWCYURqfgvaQ
HTC Throwdown - R2 Bracket - LR7: SFAT (Fox) vs Lucky (Fox)	Video:0VgkOaK5oHw	Channel:UCcLgWeVW3Z_ZWCYURqfgvaQ
HTC Throwdown - R2 Bracket - LR7: COG MVG|Mew2King (Sheik) vs Tempo|Axe (Pikachu)	Video:uWtItA9JNrU	Channel:UCcLgWeVW3Z_ZWCYURqfgvaQ
HTC Throwdown - R2 Bracket - LR6: SFAT (Fox) vs HugS (Samus)	Video:R27thUlx--w	Channel:UCcLgWeVW3Z_ZWCYURqfgvaQ
HTC Throwdown - R2 Bracket - LR6: COG MVG|Mew2King (Sheik/Marth) vs CLG.PewPewU (Marth)	Video:tjE8xBqF_eE	Channel:UCcLgWeVW3Z_ZWCYURqfgvaQ
HTC Throwdown - R2 Bracket - LR5: SP|Zhu (Falco) vs SFAT (Fox)	Video:RcIeCB21vLE	Channel:UCcLgWeVW3Z_ZWCYURqfgvaQ
HTC Throwdown - R2 Bracket - LR5: CLG.PewPewU (Marth) vs Tang (Fox)	Video:bE1ZKV95a1E	Channel:UCcLgWeVW3Z_ZWCYURqfgvaQ
HTC Throwdown - R2 Bracket - WR4: Tempo|Axe (YLink) vs Liquid`Hungrybox (Puff)	Video:zTQKTXIZ3vE	Channel:UCcLgWeVW3Z_ZWCYURqfgvaQ
HTC Throwdown - R2 Bracket - LR5: COG|Mew2King (Sheik) vs Tai (Marth)	Video:hXq9907gD3Y	Channel:UCcLgWeVW3Z_ZWCYURqfgvaQ
HTC Throwdown - R2 Bracket - LR7: SP|Cactuar (Marth) vs DruggedFox (Sheik)	Video:xKG2i2tJV5w	Channel:UCcLgWeVW3Z_ZWCYURqfgvaQ
HTC Throwdown - R2 Bracket - WR4: SS|Colbol (Marth) vs Lucky (Fox)	Video:e8SubbVeOa8	Channel:UCcLgWeVW3Z_ZWCYURqfgvaQ
HTC Throwdown - R2 Bracket - LR6: COG|Wizzrobe (C. Falcon) vs SP|Cactuar (Marth)	Video:AFv0L1UjplU	Channel:UCcLgWeVW3Z_ZWCYURqfgvaQ
HTC Throwdown - R2 Bracket - WR3: SFAT (Fox) vs Tempo|Axe (Pikachu)	Video:NcmRtCIEO7I	Channel:UCcLgWeVW3Z_ZWCYURqfgvaQ
HTC Throwdown - R2 Bracket - LR4: gaR (Sheik) vs JJs|MikeHaze (Fox)	Video:v3D4cJ21Cic	Channel:UCcLgWeVW3Z_ZWCYURqfgvaQ
HTC Throwdown - R2 Bracket - WR3: CLG.PewPewU (Marth) vs Lucky (Fox)	Video:QaPadCe96vU	Channel:UCcLgWeVW3Z_ZWCYURqfgvaQ
HTC Throwdown - R2 Bracket - LR7: WFX|Shroomed (Sheik) vs Frootloop (Falco)	Video:Kessw6L0ltQ	Channel:UCcLgWeVW3Z_ZWCYURqfgvaQ
HTC Throwdown - R2 Bracket - WR6: Tai (Marth) vs SFAT (Fox)	Video:NwZGct9opUU	Channel:UCcLgWeVW3Z_ZWCYURqfgvaQ
HTC Throwdown - R2 Bracket - WR3: Mew2King (Sheik/Marth) vs SS|Colbol (Fox)	Video:V8_FI_cbjNA	Channel:UCcLgWeVW3Z_ZWCYURqfgvaQ
HTC Throwdown - R2 Bracket - LR6: WFX|Shroomed (Sheik) vs FE|MacD (Peach)	Video:xQPNoJSOXhw	Channel:UCcLgWeVW3Z_ZWCYURqfgvaQ
HTC Throwdown - R2 Bracket - LR5: COG|Wizzrobe (C. Falcon) vs Homemadewaffles (Fox)	Video:iQuuRwjPJTM	Channel:UCcLgWeVW3Z_ZWCYURqfgvaQ
HTC Throwdown - R2 Bracket - LR5: WFX|Shroomed (Sheik) vs Liquid`Ken (Marth)	Video:YVwFxpxK4c4	Channel:UCcLgWeVW3Z_ZWCYURqfgvaQ
HTC Throwdown - R2 Bracket - WR4: GC|Silent Wolf (Fox) vs DruggedFox (Sheik)	Video:gt26vZascuY	Channel:UCcLgWeVW3Z_ZWCYURqfgvaQ
HTC Throwdown - R2 Bracket - LR5: SP|Cactuar (Marth) vs S2J (C. Falcon)	Video:zWsBVTBzl4o	Channel:UCcLgWeVW3Z_ZWCYURqfgvaQ
HTC Throwdown - R2 Bracket - LR5: C9|Mang0 (Fox) vs FE|MacD (Peach)	Video:b_G2N4Y7Juw	Channel:UCcLgWeVW3Z_ZWCYURqfgvaQ
HTC Throwdown - R2 Bracket: Liquid`Chillindude (Fox) vs CLG.PewPewU (Marth)	Video:YrKJgycOkbM	Channel:UCcLgWeVW3Z_ZWCYURqfgvaQ
HTC Throwdown - R2 Bracket - WR3: GC|Silent Wolf (Fox) vs WFX|Shroomed (Sheik)	Video:0I1qMz-9ArM	Channel:UCcLgWeVW3Z_ZWCYURqfgvaQ
HTC Throwdown - R2 Bracket: SS|Colbol (Fox) vs SP|Zhu (Sheik)	Video:zhD4fkuvsDk	Channel:UCcLgWeVW3Z_ZWCYURqfgvaQ
HTC Throwdown - R2 Bracket: Berto (Falco) vs Liquid`Ken (Marth)	Video:kQ0nMEyADwY	Channel:UCcLgWeVW3Z_ZWCYURqfgvaQ
HTC Throwdown - R2 Bracket - WR4: Frootloop (Falco) vs TSM|Leffen (Fox)	Video:kHF3jSJYeok	Channel:UCcLgWeVW3Z_ZWCYURqfgvaQ
HTC Throwdown - R2 Bracket: Rudolph (Sheik/Fox) vs COG|Wizzrobe (C. Falcon)	Video:FDqtQ5uFP_E	Channel:UCcLgWeVW3Z_ZWCYURqfgvaQ
HTC Throwdown - R2 Bracket - WR3: Frootloop (Falco) vs Homemadewaffles (Fox)	Video:1MSe6H_7xlk	Channel:UCcLgWeVW3Z_ZWCYURqfgvaQ
HTC Throwdown - R2 Bracket - WR3: C9|Mang0 (Falco) vs DruggedFox (Sheik/Marth)	Video:ZfPwnU-WYts	Channel:UCcLgWeVW3Z_ZWCYURqfgvaQ
HTC Throwdown - R2 Bracket: Rudolph (Marth) vs L (Fox)	Video:fA-fpGnZpaw	Channel:UCcLgWeVW3Z_ZWCYURqfgvaQ
HTC Throwdown - R2 Bracket - LR3: YP|Bizzarro Flame (Ganon) vs PG|Plup (Sheik)	Video:s8NdRTpmfCE	Channel:UCcLgWeVW3Z_ZWCYURqfgvaQ
HTC Throwdown - R2 Bracket - LR2: YP|Bizzarro Flame (Ganon) vs Balloon (C. Falcon)	Video:SuMZhethIoM	Channel:UCcLgWeVW3Z_ZWCYURqfgvaQ
HTC Throwdown - R2 Bracket - WR3: TSM|Leffen (Fox) vs S2J (C. Falcon)	Video:PPQO-wslJXs	Channel:UCcLgWeVW3Z_ZWCYURqfgvaQ
HTC Throwdown - R2 Bracket: Anson (Falco) vs C. Rabbit (Kirby)	Video:5mHAeo5Zr8c	Channel:UCcLgWeVW3Z_ZWCYURqfgvaQ
HTC Throwdown - R2 Bracket: HomeMadeWaffles (Fox) vs PG|Plup (Sheik)	Video:ibyVAB9VhtE	Channel:UCcLgWeVW3Z_ZWCYURqfgvaQ
HTC Throwdown - R2 Bracket - WR2: Berto (Falco) vs TSM|Leffen (Fox)	Video:FE55C0RtnlA	Channel:UCcLgWeVW3Z_ZWCYURqfgvaQ
HTC Throwdown - R2 Bracket - WR2: C9|Mang0 (Falco) vs Rudolph (Marth)	Video:BH-cp4wgf9c	Channel:UCcLgWeVW3Z_ZWCYURqfgvaQ
HTC Throwdown - R2 Bracket: WFX|Shroomed (Sheik) vs Ralph (Falco)	Video:0kltEIxkdk4	Channel:UCcLgWeVW3Z_ZWCYURqfgvaQ
HTC Throwdown - Bracket Pools: CLG.PewPewU (Marth) vs Mooninite (C. Falcon)	Video:YwBCFrMH0ms	Channel:UCcLgWeVW3Z_ZWCYURqfgvaQ
HTC Throwdown - Bracket Pools: ycz6 (Samus) vs SP|Zhu (Sheik)	Video:ohsEwUOtmrw	Channel:UCcLgWeVW3Z_ZWCYURqfgvaQ
HTC Throwdown - Bracket Pools: GC|Silent Wolf (Fox) vs BlueFoxXT (Puff)	Video:o0JijPF36Y4	Channel:UCcLgWeVW3Z_ZWCYURqfgvaQ
HTC Throwdown - Bracket Pools: gaR (Sheik) vs SP|Cactuar (Marth)	Video:fLdz7TK0A1I	Channel:UCcLgWeVW3Z_ZWCYURqfgvaQ
HTC Throwdown - Bracket Pools: ViciousVish (C. Falcon) vs HMW (Fox)	Video:aJKkNR6f3ec	Channel:UCcLgWeVW3Z_ZWCYURqfgvaQ
HTC Throwdown - Bracket Pools: Tang (Fox) vs  Druggedfox (Sheik)	Video:pt5qrDMvwg0	Channel:UCcLgWeVW3Z_ZWCYURqfgvaQ
HTC Throwdown - Bracket Pools: Alex19 (Fox) vs Zoap (Peach)	Video:bImos0cq0_U	Channel:UCcLgWeVW3Z_ZWCYURqfgvaQ
HTC Throwdown - Bracket Pools: Berto (Falco) vs Fat Goku (Fox)	Video:78jQr0g_Inw	Channel:UCcLgWeVW3Z_ZWCYURqfgvaQ
HTC Throwdown - Bracket Pools: Siglemic (Fox) vs SP|Cactuar (Marth)	Video:jyYfNKHQnBY	Channel:UCcLgWeVW3Z_ZWCYURqfgvaQ
HTC Throwdown - Bracket Pools: MIOM|Scar (C. Falcon) vs Pinky (C. Falcon)	Video:eBEkkWtNLe8	Channel:UCcLgWeVW3Z_ZWCYURqfgvaQ
HTC Throwdown - Bracket Pools: nhat (Marth) vs Rustin (Peach)	Video:oT-14zdisdg	Channel:UCcLgWeVW3Z_ZWCYURqfgvaQ
HTC Throwdown - Bracket Pools: ViciousVish (C. Falcon) vs Zeo (C. Falcon)	Video:q9nKEbtmE8A	Channel:UCcLgWeVW3Z_ZWCYURqfgvaQ
HTC Throwdown - Bracket Pools: Kat in the Sac (Falco) vs GC|Silent Wolf (Fox/Falco)	Video:rgmT9aNKvjQ	Channel:UCcLgWeVW3Z_ZWCYURqfgvaQ
HTC Throwdown - Bracket Pools: gaR (Sheik) vs Zbert (Fox)	Video:bJiYIj7AQJ8	Channel:UCcLgWeVW3Z_ZWCYURqfgvaQ
HTC Throwdown - Bracket Pools: Eleven (Sheik) vs SilentSpectre (C. Falcon)	Video:x8w6zHm2pHE	Channel:UCcLgWeVW3Z_ZWCYURqfgvaQ
HTC Throwdown - Bracket Pools: Liquid`Ken (Marth) vs Reason (Dr. Mario)	Video:7nz11qMTEck	Channel:UCcLgWeVW3Z_ZWCYURqfgvaQ
HTC Throwdown - Bracket Pools - WR4: Tempo|Axe (Pikachu/Ylink) vs BERT|Doyoung2win (Puff)	Video:57JsfDFz_Lk	Channel:UCcLgWeVW3Z_ZWCYURqfgvaQ
HTC Throwdown - Bracket Pools: Rudolph (Marth) vs Alan (Peach/Sheik)	Video:vFIEqigBW5E	Channel:UCcLgWeVW3Z_ZWCYURqfgvaQ
HTC Throwdown - Bracket Pools - WR4: Zeldafreak (Fox) vs COG MVG|Mew2King (Sheik/Marth)	Video:Hecimju4nHg	Channel:UCcLgWeVW3Z_ZWCYURqfgvaQ
HTC Throwdown - Bracket Pools - WR4: Berble (Fox) vs TSM|Leffen (Fox)	Video:QyhrnNa57sA	Channel:UCcLgWeVW3Z_ZWCYURqfgvaQ
HTC Throwdown - Bracket Pools: WFX|Shroomed (Sheik) vs eBay (C. Falcon)	Video:AJMjDVuNBUU	Channel:UCcLgWeVW3Z_ZWCYURqfgvaQ
HTC Throwdown - Bracket Pools - WR4: Emanon (Peach) vs C9|Mang0 (Fox)	Video:LHTvCDdqNRw	Channel:UCcLgWeVW3Z_ZWCYURqfgvaQ
HTC Throwdown - Bracket Pools: SS|Colbol (Fox) vs ArcadianChamp|BarDulL (Marth)	Video:iYlv9xq-HRY	Channel:UCcLgWeVW3Z_ZWCYURqfgvaQ
HTC Throwdown - Bracket Pools - WR4: Balloon (Marth) vs Liquid`HungryBox (Puff)	Video:tkhNiAH96ao	Channel:UCcLgWeVW3Z_ZWCYURqfgvaQ
HTC Throwdown - Bracket Pools: Reno (Sheik) vs L (Fox)	Video:Q4SdAWazmvE	Channel:UCcLgWeVW3Z_ZWCYURqfgvaQ
HTC Throwdown - Bracket Pools: Reason (Doc) vs Goose (Pikachu)	Video:Cuc2XoMs66o	Channel:UCcLgWeVW3Z_ZWCYURqfgvaQ
HTC Throwdown - Bracket Pools: BERT|DoYoung2Win (Falco/Puff) vs Imyt (Falco/Dr. Mario)	Video:OvSziOniG5E	Channel:UCcLgWeVW3Z_ZWCYURqfgvaQ
HTC Throwdown - Bracket Pools: Berble (Fox) vs PikminButDeadly (Fox)	Video:nZyT6aKoVI4	Channel:UCcLgWeVW3Z_ZWCYURqfgvaQ
HTC Throwdown - Bracket Pools: Rudolph (Sheik) vs BERT|Bertbusdriver (C. Falcon)	Video:_Z6-T2dBbik	Channel:UCcLgWeVW3Z_ZWCYURqfgvaQ
HTC Throwdown - Bracket Pools: C9|Mang0 (Fox) vs Somekid (Peach)	Video:_KVNI7sdNDU	Channel:UCcLgWeVW3Z_ZWCYURqfgvaQ
HTC Throwdown - Bracket Pools: ahmad (Fox) vs Emanon (Peach)	Video:MVnOaUVRSY4	Channel:UCcLgWeVW3Z_ZWCYURqfgvaQ
HTC Throwdown - Bracket Pools: SS|Colbol (Fox) vs Zander (Puff)	Video:qlgq58BZmJA	Channel:UCcLgWeVW3Z_ZWCYURqfgvaQ
HTC Throwdown - Bracket Pools: TSM|Leffen (Falco) vs Nishi (Marth)	Video:xXITJCc7h0I	Channel:UCcLgWeVW3Z_ZWCYURqfgvaQ
HTC Throwdown - Bracket Pools: Reno (Sheik) vs Nipunn (Pikachu)	Video:itAeo2tUiz0	Channel:UCcLgWeVW3Z_ZWCYURqfgvaQ
HTC Throwdown - Bracket Pools: YP|Bizzarro Flame (Ganon) vs Liquid`Chillindude (Fox)	Video:V_z9jA1Rx54	Channel:UCcLgWeVW3Z_ZWCYURqfgvaQ
HTC Throwdown - Bracket Pools: HugS (Samus) vs Phil (Fox)	Video:rta0a1sICpw	Channel:UCcLgWeVW3Z_ZWCYURqfgvaQ
HTC Throwdown - Bracket Pools: Tai (Marth) vs JJs|MikeHaze (Fox)	Video:zjhozgfVo8I	Channel:UCcLgWeVW3Z_ZWCYURqfgvaQ
HTC Throwdown - Bracket Pools: COG|Wizzrobe (C. Falcon) vs SB|TheBigOPness (Marth)	Video:fWuCQU5rOB0	Channel:UCcLgWeVW3Z_ZWCYURqfgvaQ
HTC Throwdown - Bracket Pools: FF|Mr. Brandandorf (Ganon) vs PG|Plup (Sheik)	Video:qXwmOXfJeUg	Channel:UCcLgWeVW3Z_ZWCYURqfgvaQ
HTC Throwdown - Bracket Pools: S2J (C. Falcon) vs Coolkid (Falco)	Video:fAykJtvzims	Channel:UCcLgWeVW3Z_ZWCYURqfgvaQ
HTC Throwdown - Bracket Pools: Laudandus (Sheik) vs Hyprid (Marth)	Video:K_2PNqfBonA	Channel:UCcLgWeVW3Z_ZWCYURqfgvaQ
HTC Throwdown - Bracket Pools: Phil (Fox) vs Skeeter (Peach)	Video:kjcSa1EgioU	Channel:UCcLgWeVW3Z_ZWCYURqfgvaQ
HTC Throwdown - Bracket Pools: Nimzo (Falco) vs Azusa (Peach)	Video:jPgh-8mtrtc	Channel:UCcLgWeVW3Z_ZWCYURqfgvaQ
HTC Throwdown - Bracket Pools: Tai (Marth) vs Chroma (Marth)	Video:1fy7ImJ9V-k	Channel:UCcLgWeVW3Z_ZWCYURqfgvaQ
HTC Throwdown - Bracket Pools: FF|Mr. Brandandorf (Ganon) vs Arcadia (Marth)	Video:GJTtZrxPAHA	Channel:UCcLgWeVW3Z_ZWCYURqfgvaQ
HTC Throwdown - Bracket Pools: S2J (C. Falcon) vs Salty Seth (Fox)	Video:NqwGRgYBOho	Channel:UCcLgWeVW3Z_ZWCYURqfgvaQ
HTC Throwdown - Bracket Pools: HugS (Samus) vs Dolla Bill Bill (Fox)	Video:dGE-LjmL59s	Channel:UCcLgWeVW3Z_ZWCYURqfgvaQ
HTC Throwdown - Bracket Pools: UW|Toiya (Fox) vs Liquid`Chillindude (Fox/Falco)	Video:dJs0NLTHqF8	Channel:UCcLgWeVW3Z_ZWCYURqfgvaQ
HTC Throwdown - Bracket Pools: Coolkid (Falco) vs Griffin (Sheik/Ganon)	Video:LX-jMIz0g2U	Channel:UCcLgWeVW3Z_ZWCYURqfgvaQ
HTC Throwdown - Bracket Pools: YP|Bizzarro Flame (Ganon) vs UW|Calvin (Falco)	Video:yMP4YkxgeaU	Channel:UCcLgWeVW3Z_ZWCYURqfgvaQ
HTC Throwdown - Bracket Pools: SB|TheBigOPness (Marth) vs Maybe (ICs/Peach)	Video:EW6zDu4rP_I	Channel:UCcLgWeVW3Z_ZWCYURqfgvaQ
HTC Throwdown - Bracket Pools: HydroKirby (Falco) vs Foop (Ganon)	Video:3dvxFbSndzM	Channel:UCcLgWeVW3Z_ZWCYURqfgvaQ
Team Liquid LoL | Vlog 03 - Visas, Top Lane, and Worlds	Video:ghc7z9JNpQc	Channel:UCcLgWeVW3Z_ZWCYURqfgvaQ
HTC Vive | Pax Prime	Video:Oc_2oFxd5qs	Channel:UCcLgWeVW3Z_ZWCYURqfgvaQ
HTC Throwdown | Sep 19th, 2015 - San Francisco, CA	Video:B07K3dAw3LA	Channel:UCcLgWeVW3Z_ZWCYURqfgvaQ
Team Liquid | Rebirth EP13 - Roads	Video:mjULHy4kiHI	Channel:UCcLgWeVW3Z_ZWCYURqfgvaQ
Team Liquid | Rebirth EP12 - Family	Video:_sxp-WLDvvo	Channel:UCcLgWeVW3Z_ZWCYURqfgvaQ
Team Liquid LoL | Vlog 02 - TSM & the Road to MSG	Video:Z-2enPasRRE	Channel:UCcLgWeVW3Z_ZWCYURqfgvaQ
HTC | A Worthy Opponent	Video:wRy4TIwPMaM	Channel:UCcLgWeVW3Z_ZWCYURqfgvaQ
HTC | Bring Your Game	Video:1kpdO082osY	Channel:UCcLgWeVW3Z_ZWCYURqfgvaQ
Team Liquid | Rebirth EP11 - First	Video:X7llXEWi__Y	Channel:UCcLgWeVW3Z_ZWCYURqfgvaQ
C9 Dota 2 | Bootcamp Interview - Fata- [TI5]	Video:esjcLySxqVw	Channel:UCcLgWeVW3Z_ZWCYURqfgvaQ
C9 Dota 2 | Bootcamp Interview - bOne7 [TI5]	Video:tVO0Jk-PPtg	Channel:UCcLgWeVW3Z_ZWCYURqfgvaQ
C9 Dota 2 | Bootcamp Interview - BigDaddyN0tail [TI5]	Video:KlFeY0Rcr4w	Channel:UCcLgWeVW3Z_ZWCYURqfgvaQ
C9 Dota 2 | Bootcamp Interview - MiSeRy [TI5]	Video:zCD2t3UPEhE	Channel:UCcLgWeVW3Z_ZWCYURqfgvaQ
C9 Dota 2 | HTC Bootcamp Tour w/HotBid & Conrad	Video:bY0AlBkPYI4	Channel:UCcLgWeVW3Z_ZWCYURqfgvaQ
C9 Dota 2 | Bootcamp Interview - EternaLEnVy [TI5]	Video:nycf0jL-g1c	Channel:UCcLgWeVW3Z_ZWCYURqfgvaQ
Team Liquid | Rebirth EP10 - Rise	Video:_aHEGc4U5m0	Channel:UCcLgWeVW3Z_ZWCYURqfgvaQ
Team Liquid | Rebirth EP09 - Memories	Video:Igynu5cmUmA	Channel:UCcLgWeVW3Z_ZWCYURqfgvaQ
Recall with Thorin | Interview - C9 Incarnation	Video:ZFFP4VWJEeI	Channel:UCcLgWeVW3Z_ZWCYURqfgvaQ
Recall with Thorin | Interview - C9 Meteos	Video:7S4YDNmlziE	Channel:UCcLgWeVW3Z_ZWCYURqfgvaQ
#AskTSM - Ep. 2	Video:xy0qqGgja-Y	Channel:UCcLgWeVW3Z_ZWCYURqfgvaQ
Team Liquid | Rebirth EP08 - Fearless	Video:wajnd889VmE	Channel:UCcLgWeVW3Z_ZWCYURqfgvaQ
CS:GO | HTC Reborn Highlights	Video:U9bkQYOw-Go	Channel:UCcLgWeVW3Z_ZWCYURqfgvaQ
Recall with Thorin | Interview - C9 Balls	Video:EQtUc7j-DzE	Channel:UCcLgWeVW3Z_ZWCYURqfgvaQ
Hai's Retirement	Video:QjDREIsmOXo	Channel:UCcLgWeVW3Z_ZWCYURqfgvaQ
Team Liquid | Rebirth Season 2 - Trailer	Video:rndCU9TRJAs	Channel:UCcLgWeVW3Z_ZWCYURqfgvaQ
Cloud9 vs Tempo Storm - Map 3 - Dust 2 (HTC Reborn Invitational)	Video:NvwiFTjEM7M	Channel:UCcLgWeVW3Z_ZWCYURqfgvaQ
Liquid vs Cloud9 - Map 2 - Dust 2 (HTC Reborn Invitational)	Video:mNwFcXT1uuI	Channel:UCcLgWeVW3Z_ZWCYURqfgvaQ
Liquid vs Cloud9 - Map 1 - Cache (HTC Reborn Invitational)	Video:Nrq62eAtngc	Channel:UCcLgWeVW3Z_ZWCYURqfgvaQ
Team Liquid LoL | Vlog 01 - Seasons Start	Video:nNy4crdc950	Channel:UCcLgWeVW3Z_ZWCYURqfgvaQ
HTC: Reborn - North America	Video:jonOza3bOXc	Channel:UCcLgWeVW3Z_ZWCYURqfgvaQ
Team Liquid | Rebirth EP07 - Hawaii	Video:v8zyGjtvjDk	Channel:UCcLgWeVW3Z_ZWCYURqfgvaQ
Team Liquid | Rebirth EP01 - Conversation	Video:bhFK-JmQC7o	Channel:UCcLgWeVW3Z_ZWCYURqfgvaQ
Team Liquid | Rebirth EP02 - Arrival	Video:jy84jlP8eVU	Channel:UCcLgWeVW3Z_ZWCYURqfgvaQ
Team Liquid | Rebirth EP03 - Decision	Video:47xqLJGEODk	Channel:UCcLgWeVW3Z_ZWCYURqfgvaQ
Team Liquid | Rebirth EP04 - Expectations	Video:kM45wMLxrpg	Channel:UCcLgWeVW3Z_ZWCYURqfgvaQ
Team Liquid | Rebirth EP05 - Confidence	Video:rj1AXTzRhqk	Channel:UCcLgWeVW3Z_ZWCYURqfgvaQ
Team Liquid | Rebirth EP06 - Ambition	Video:RSX13GAGiZM	Channel:UCcLgWeVW3Z_ZWCYURqfgvaQ
Team Liquid Reacts To: Power Rankings - NA LCS Summer Split 2015	Video:odcBTzPCwic	Channel:UCcLgWeVW3Z_ZWCYURqfgvaQ
Team Liquid Reacts To: Roster Shuffle - NA LCS Summer Split 2015	Video:zaD_suSHTac	Channel:UCcLgWeVW3Z_ZWCYURqfgvaQ
