Mew2King's Pichu SSBM Beginner's Guide - How to Embarrass with Pichu	Video:Q3yexswM15Q	Channel:UC_dkX2_MJZeiYZImFN8AOvg
Final Fantasy XV Later	Video:3Nb03w6x0ZE	Channel:UC_dkX2_MJZeiYZImFN8AOvg
Discovering the Z-Axis in Melee & How it Works	Video:jvXAmWBxTu4	Channel:UC_dkX2_MJZeiYZImFN8AOvg
Mew2King Tips & Tricks: Overshooting & Undershooting - Melee	Video:tVjV6SOevI4	Channel:UC_dkX2_MJZeiYZImFN8AOvg
Smash 4 at the MVG HQ	Video:N-ZNiMsxT80	Channel:UC_dkX2_MJZeiYZImFN8AOvg
Mew2King Thanksgiving Day Mario Maker Stream	Video:r17X5a5wOqY	Channel:UC_dkX2_MJZeiYZImFN8AOvg
Mew2King Falling with Fox	Video:lJ7IrLLmO_o	Channel:UC_dkX2_MJZeiYZImFN8AOvg
Mew2King Melee w/ Viewers & DrunkSloth, Smash4 Later	Video:tgCpkjHbAas	Channel:UC_dkX2_MJZeiYZImFN8AOvg
Mew2King Melee with Pi & Cruddo	Video:4F_k2L3TCjo	Channel:UC_dkX2_MJZeiYZImFN8AOvg
Mew2King Tips & Tricks: Conditioning, Mixups & Reacting - Melee	Video:273tHua4wGc	Channel:UC_dkX2_MJZeiYZImFN8AOvg
Top 5 Clutch Plays of Smash Conference: 68	Video:dvYeS_0Id5U	Channel:UC_dkX2_MJZeiYZImFN8AOvg
Mew2King Melee Exhibitions with Kaike from CFL	Video:U-CrW2dh81U	Channel:UC_dkX2_MJZeiYZImFN8AOvg
Smash 4 w/ M2K and Brand, Chez later on	Video:Tib-xCINgMA	Channel:UC_dkX2_MJZeiYZImFN8AOvg
How Mew2King Celebrates!	Video:ejuMB6LmPkA	Channel:UC_dkX2_MJZeiYZImFN8AOvg
Melee w/ FBC Lad. Smash Conference is live! smash.gg/SC69	Video:-cUvPaCOhbo	Channel:UC_dkX2_MJZeiYZImFN8AOvg
Flat Zone Tiny Melee Mini Game	Video:O-iNKHZLcAU	Channel:UC_dkX2_MJZeiYZImFN8AOvg
"Did You Know?"	Video:ztQf4GdiKQQ	Channel:UC_dkX2_MJZeiYZImFN8AOvg
More LIVE netplay w/ M2K	Video:5jLVS24yQrY	Channel:UC_dkX2_MJZeiYZImFN8AOvg
M2K x WizZy ft. IrregularJinny (Part 2)	Video:F41EExAHu2w	Channel:UC_dkX2_MJZeiYZImFN8AOvg
Ganon Ditto Master - Plup vs. Mew2King - SSBM	Video:ZkjumTtTaiE	Channel:UC_dkX2_MJZeiYZImFN8AOvg
M2K & WizZy Exhibitions ft. IrregularJinny from Sweden!	Video:8KrZomJCr60	Channel:UC_dkX2_MJZeiYZImFN8AOvg
Mew2King vs. Salem in BRAWL	Video:HHHTjK_Djv4	Channel:UC_dkX2_MJZeiYZImFN8AOvg
2 Players, 1 Controller Challenge - Break the Targets	Video:SQQlk8zePmw	Channel:UC_dkX2_MJZeiYZImFN8AOvg
M2K Got Netplay Working	Video:KBVy4twH7PU	Channel:UC_dkX2_MJZeiYZImFN8AOvg
The King of the Kongs	Video:5pJurIZqN0k	Channel:UC_dkX2_MJZeiYZImFN8AOvg
Mew2King introduces Melee's WORST Hitbox	Video:YF_B0xT2Xuc	Channel:UC_dkX2_MJZeiYZImFN8AOvg
Mew2King & Plup Play to the Music of Melee	Video:ssui0IdzS9g	Channel:UC_dkX2_MJZeiYZImFN8AOvg
M2K Testing Controllers before Summit	Video:TPX03NTD0r8	Channel:UC_dkX2_MJZeiYZImFN8AOvg
"I'm SWITCHING Mains." - Mew2King	Video:3_JP1meOq_Y	Channel:UC_dkX2_MJZeiYZImFN8AOvg
Mew2King says Water (Clickbait)	Video:iHuSkGT8GEc	Channel:UC_dkX2_MJZeiYZImFN8AOvg
Smash 4 Today with M2K	Video:TSvlPCv5FrE	Channel:UC_dkX2_MJZeiYZImFN8AOvg
M2K & Plup Melee Exhibitions	Video:diSjTcxVel8	Channel:UC_dkX2_MJZeiYZImFN8AOvg
FOX|MVG|Mew2King (Cloud) vs. Instinct Spark (Sonic) - Wii U Grand Finals - CTP2	Video:OYvb83IPO20	Channel:UC_dkX2_MJZeiYZImFN8AOvg
Instinct Spark (Sonic) vs. Shoq|Rideae (Pikachu) - Wii U Losers Finals - CTP2	Video:s7SGoX86DU4	Channel:UC_dkX2_MJZeiYZImFN8AOvg
Myran (Olimar) vs. Shoq|Rideae (Pikachu) - Wii U Losers Semis - CTP2	Video:VYvJwA34TRQ	Channel:UC_dkX2_MJZeiYZImFN8AOvg
FOX|MVG|Mew2King (Cloud) vs. Instinct Spark (Sonic) - Wii U Winners Finals - CTP2	Video:MhFCKkrRLyY	Channel:UC_dkX2_MJZeiYZImFN8AOvg
Shoq|Rideae (Sheik) vs. GoTE|8BitMan (ROB) - Wii U Losers Quarters - CTP2	Video:vR3IMbCwtsU	Channel:UC_dkX2_MJZeiYZImFN8AOvg
FOX|MVG|Mew2King (Cloud) vs. GoTE|8BitMan (ROB) - Wii U Winners Semis - CTP2	Video:o7qYlwTdJgw	Channel:UC_dkX2_MJZeiYZImFN8AOvg
Myran (Olimar) vs. Wormynugget (Diddy Kong & Fox) - Wii U Losers Quarters - CTP2	Video:Y3Np841jaic	Channel:UC_dkX2_MJZeiYZImFN8AOvg
Instinct Spark (Sonic) vs. PPG|Josh (Diddy Kong) - Wii U Winners Semis - CTP2	Video:E4zhryLKu2o	Channel:UC_dkX2_MJZeiYZImFN8AOvg
Prince Ramen (Palutena) vs. Myran (Olimar) - Wii U Losers Eighths - CTP2	Video:ksz8XlKs6Fg	Channel:UC_dkX2_MJZeiYZImFN8AOvg
FOX|MVG|Mew2King & Prince Ramen vs. Instinct Spark & VexX|Day - Wii U Doubles Grand Finals - CTP2	Video:KhfTyAI32X4	Channel:UC_dkX2_MJZeiYZImFN8AOvg
Shoq|Rideae (Pikachu) vs. MVG|dyr (Diddy Kong) - Wii U Losers Eighths - CTP2	Video:MZgeQsBU164	Channel:UC_dkX2_MJZeiYZImFN8AOvg
Tachyon & DMG.Ross vs. FOX|MVG|Mew2King & Prince Ramen - Wii U Doubles Losers Finals - CTP2	Video:PnYmtnNP-6g	Channel:UC_dkX2_MJZeiYZImFN8AOvg
Tachyon & DMG.Ross vs. MVG|dyr & Fatality - Wii U Doubles Losers Semis - CTP2	Video:ejcEVuTPFDs	Channel:UC_dkX2_MJZeiYZImFN8AOvg
FOX|MVG|Mew2King & Prince Ramen vs. Instinct Spark & VexX|Day - Wii U Doubles Winners Finals - CTP2	Video:mjWIFzdNjoU	Channel:UC_dkX2_MJZeiYZImFN8AOvg
Tachyon & DMG.Ross vs. Eden & Wormynugget - Wii U Doubles Losers Quarters - CTP2	Video:fIlwMSnuSg0	Channel:UC_dkX2_MJZeiYZImFN8AOvg
FOX|MVG|Mew2King & Prince Ramen vs. Tachyon & DMG.Ross - Wii U Doubles Winners Semis - CTP2	Video:kILPwGDjWWA	Channel:UC_dkX2_MJZeiYZImFN8AOvg
MVG|dyr & Fatality vs. DJ Jack & ATR|Xaltis - Wii U Doubles Losers Quarters - CTP2	Video:3DwqEUjpufw	Channel:UC_dkX2_MJZeiYZImFN8AOvg
Eden & Wormy vs. Riot & Poltergust - Wii U Doubles Losers Eighths - CTP2	Video:XTzAjNNjSYY	Channel:UC_dkX2_MJZeiYZImFN8AOvg
FOX|MVG|Mew2King (Sheik) vs. PG|Plup (Sheik) - Melee Grand Finals - CTP2	Video:tX1wuWolPLQ	Channel:UC_dkX2_MJZeiYZImFN8AOvg
DJ Jack & ATR|Xaltis vs. Noble|Ryo & Noble|Sol - Wii U Doubles Losers Eighths - CTP2	Video:LK6zwFDSWF0	Channel:UC_dkX2_MJZeiYZImFN8AOvg
FOX|MVG|Mew2King (Sheik) vs. COG|Wizzrobe (C. Falcon) - Melee Losers Finals - CTP2	Video:0LkHQETkEB0	Channel:UC_dkX2_MJZeiYZImFN8AOvg
MVG|dyr & Fatality vs. VexX|Day & Instinct Spark - Wii U Doubles Winners Semis - CTP2	Video:K976-GYJrZQ	Channel:UC_dkX2_MJZeiYZImFN8AOvg
FOX|MVG|Mew2King (Sheik) vs. PG|Plup (Sheik) - Melee Winners Finals - CTP2	Video:jTBkt7g5BP8	Channel:UC_dkX2_MJZeiYZImFN8AOvg
COG|Wizzrobe (C. Falcon) vs. U4X|20GX Gahtzu (C. Falcon) - Melee Losers Semis - CTP2	Video:zdNdHvWNONM	Channel:UC_dkX2_MJZeiYZImFN8AOvg
COG|Wizzrobe (C. Falcon) vs. SS|Colbol (Fox) - Melee Losers Quarters - CTP2	Video:PtCbnuc6ieA	Channel:UC_dkX2_MJZeiYZImFN8AOvg
U4X|20GX Gahtzu (C. Falcon) vs. Pengie (Fox) - Melee Losers Quarters - CTP2	Video:VHF9gcqpvJU	Channel:UC_dkX2_MJZeiYZImFN8AOvg
COG|Wizzrobe (C. Falcon) vs. PG|Plup (Sheik & Fox) - Melee Winners Semis - CTP2	Video:TO1Ay7Uj-_s	Channel:UC_dkX2_MJZeiYZImFN8AOvg
FOX|MVG|Mew2King (Sheik) vs. U4X|20GX Gahtzu (C. Falcon) - Melee Winners Semis - CTP2	Video:IbMhea7dqqg	Channel:UC_dkX2_MJZeiYZImFN8AOvg
VS|PPG Porkchops (Falco) vs. Pengie (Fox) - Melee Losers Top 8 - CTP2	Video:iaebDU2Q6LI	Channel:UC_dkX2_MJZeiYZImFN8AOvg
Drunk Sloth (Ice Climbers) vs. SS|Colbol (Fox) - Melee Losers Top 8 - CTP2	Video:igPt4rEKlMI	Channel:UC_dkX2_MJZeiYZImFN8AOvg
Apollo & Pengie vs. PG|Plup & FOX|MVG|Mew2King - Melee Doubles Grand Finals - CTP2	Video:368AbCA3L9c	Channel:UC_dkX2_MJZeiYZImFN8AOvg
Apollo & Pengie vs. Colbol & DrunkSloth - Melee Doubles Losers Finals - CTP2	Video:fng5Gau8HAQ	Channel:UC_dkX2_MJZeiYZImFN8AOvg
FOX|MVG|Mew2King & PG|Plup vs. Colbol & DrunkSloth - Melee Doubles Winners Finals - CTP2	Video:0-kM8fvy5rA	Channel:UC_dkX2_MJZeiYZImFN8AOvg
MVG|dyr (Diddy Kong) vs. Mugi (Corrin) - Wii U Top 16 - CTP2	Video:u3623Ys_-eY	Channel:UC_dkX2_MJZeiYZImFN8AOvg
Rogue Penguin (Mario) vs. Myran (Olimar) - Wii U Top 16 - CTP2	Video:XIBZ3H6dXlc	Channel:UC_dkX2_MJZeiYZImFN8AOvg
COG|Wizzrobe (Sheik) vs. Shoq|Rideae (Pikachu) - Wii U Top 16 - CTP2	Video:71gXG5H20d0	Channel:UC_dkX2_MJZeiYZImFN8AOvg
MVG|dyr (Diddy Kong) vs. FBC|Leo Heart (Mewtwo) - Wii U Top 16 - CTP2	Video:TG9SFaW61qc	Channel:UC_dkX2_MJZeiYZImFN8AOvg
7s|Saj (Bayonetta) vs. Shoq|Rideae (Pikachu) - Wii U Top 64 - CTP2	Video:n06YFxuQbnU	Channel:UC_dkX2_MJZeiYZImFN8AOvg
Noble|Ryo (Ike) vs. Prince Ramen (Palutena) - Wii U Top 64 - CTP2	Video:Xto-cxZ3PVY	Channel:UC_dkX2_MJZeiYZImFN8AOvg
Fatality (C. Falcon) vs. Myran (Olimar) - Wii U Top 64 - CTP2	Video:MXux-NZQzrc	Channel:UC_dkX2_MJZeiYZImFN8AOvg
PPG|Josh (Diddy Kong) vs. Mugi (Corrin) - Wii U Top 64 - CTP2	Video:uOkTy7k-_2I	Channel:UC_dkX2_MJZeiYZImFN8AOvg
COG|Wizzrobe (Sheik) vs. Instinct Spark (Sonic) - Wii U Top 64 - CTP2	Video:OD4rP8FOydE	Channel:UC_dkX2_MJZeiYZImFN8AOvg
Rogue Penguin (Mario) vs. GoTE|8BitMan (ROB) - Wii U Top 64 - CTP2	Video:-vQMWCB7cY0	Channel:UC_dkX2_MJZeiYZImFN8AOvg
FOX|MVG|Mew2King (Cloud) vs. Noble|Ryo (Roy & Corrin) - Wii U Top 64 - CTP2	Video:NWfSLY2dt0M	Channel:UC_dkX2_MJZeiYZImFN8AOvg
Prince Ramen (Palutena) vs. Mugi (Corrin) - Wii U Top 64 - CTP2	Video:phjM2Rli974	Channel:UC_dkX2_MJZeiYZImFN8AOvg
Fatality (C. Falcon & Mario) vs. COG|Wizzrobe (Sheik) - Wii U Top 64 - CTP2	Video:35s6FznKJZo	Channel:UC_dkX2_MJZeiYZImFN8AOvg
Rogue Penguin (Mario) vs. CrazieCuban (Toon Link & Diddy Kong) - Wii U Top 64 - CTP2	Video:rkCu5slvBVo	Channel:UC_dkX2_MJZeiYZImFN8AOvg
Myran (Olimar) vs. Instinct Spark (Sonic) - Wii U Top 64 - CTP2	Video:TGNQk9OzALw	Channel:UC_dkX2_MJZeiYZImFN8AOvg
FOX|MVG|Mew2King (Cloud) vs. FBC|Leo Heart (Mewtwo) - Wii U Top 64 - CTP2	Video:xnApkmDegqQ	Channel:UC_dkX2_MJZeiYZImFN8AOvg
Noble|Ryo (Ike) vs. FBC|cE Ookami (Mega Man) - Wii U Top 64 - CTP2	Video:ZmGec5fFEEY	Channel:UC_dkX2_MJZeiYZImFN8AOvg
7s|Saj (Bayonetta) vs. GoTE|8BitMan (Diddy Kong) - Wii U Top 64 - CTP2	Video:aCSpeqKjjL4	Channel:UC_dkX2_MJZeiYZImFN8AOvg
Mugi (Corrin) vs. VeXX|Day (Lucario) - Wii U Top 64 - CTP2	Video:2enVdGuM0G8	Channel:UC_dkX2_MJZeiYZImFN8AOvg
Rogue Penguin (Mario) vs. Poltergust (Yoshi) - Wii U Top 64 - CTP2	Video:eyfNKKjb_Bw	Channel:UC_dkX2_MJZeiYZImFN8AOvg
DJ Jack (Ryu) vs. Myran (Olimar) - Wii U Top 64 - CTP2	Video:bMcoCJpu3Dw	Channel:UC_dkX2_MJZeiYZImFN8AOvg
FOX|MVG|Mew2King (Cloud) vs. Port (Pac-Man) - Wii U Top 64 - CTP2	Video:Hu8NBUTyeXo	Channel:UC_dkX2_MJZeiYZImFN8AOvg
BC|Purple Guy (Zelda & Sheik) vs. Prince Ramen (Palutena) - Wii U Top 64 - CTP2	Video:bSG-8kBRW7Q	Channel:UC_dkX2_MJZeiYZImFN8AOvg
Mars Wonderboy (Mario) vs. Saj (Bayonetta) - Wii U Top 64 - CTP2	Video:l5hTE11rzCI	Channel:UC_dkX2_MJZeiYZImFN8AOvg
Depth (Samus) vs. G4C|WonderBread (Little Mac) - Wii U Top 64 - CTP2	Video:Ngp13AeSk5g	Channel:UC_dkX2_MJZeiYZImFN8AOvg
ewok41 (Cloud) vs. DMG|Ross (Toon Link & Cloud) - Wii U Top 64 - CTP2	Video:5EgR_IrQ-2o	Channel:UC_dkX2_MJZeiYZImFN8AOvg
FBC|cE Ookami (Mega Man) vs. Tito (Diddy Kong) - Wii U Winners R1 - CTP2	Video:vxJYHTYT0aI	Channel:UC_dkX2_MJZeiYZImFN8AOvg
Shoq|Rideae (Pikachu) vs. CB|Chez (Sonic) - Wii U Winners R1 - CTP2	Video:FuQJb25wpyQ	Channel:UC_dkX2_MJZeiYZImFN8AOvg
Professor Oats (Yoshi) vs. GXG|Duffo (Little Mac) - Wii U Winners R1 - CTP2	Video:e6Fb9fu29pw	Channel:UC_dkX2_MJZeiYZImFN8AOvg
Come to Papa 2 Broadcast Day 2	Video:_2WgyFf-Xo0	Channel:UC_dkX2_MJZeiYZImFN8AOvg
SUDDEN DEATH GRAND FINALS - Random Teams 2v2v2v2 - CTP2	Video:hAvwTNtron4	Channel:UC_dkX2_MJZeiYZImFN8AOvg
Zae & MasK vs. AkashicSword & Poltergust - Random Teams - CTP2	Video:byCeY4WnDQA	Channel:UC_dkX2_MJZeiYZImFN8AOvg
Don & Delta vs. Hiro & YourMom - Random Teams - CTP2	Video:USYqa4pUKY0	Channel:UC_dkX2_MJZeiYZImFN8AOvg
Asmodemus & AkashicSword vs. Purple Guy & True Blue - Random Teams - CTP2	Video:Ar4Z4xNc_2U	Channel:UC_dkX2_MJZeiYZImFN8AOvg
MasK & Delta vs. Bran & Murabito - Random Teams - CTP2	Video:bVR5HcagniI	Channel:UC_dkX2_MJZeiYZImFN8AOvg
Josh & Leo Heart vs. 7 & 8BitMan - Random Teams - CTP2	Video:FgnMFAdxeWw	Channel:UC_dkX2_MJZeiYZImFN8AOvg
GOD & Admiral Funk vs. PRoGGy & Poltergust - Random Teams - CTP2	Video:0DqgPLPylf0	Channel:UC_dkX2_MJZeiYZImFN8AOvg
Professor Oats & Lvl. 9 vs. Noble|Sol & Lvl. 9 - Random Teams - CTP2	Video:W8bdoEQO9G8	Channel:UC_dkX2_MJZeiYZImFN8AOvg
Depth (Samus) vs. Noble|Sol (Little Mac) - Wii U RR Pools - CTP2	Video:50tYmjpZi3w	Channel:UC_dkX2_MJZeiYZImFN8AOvg
PPG|Josh (Diddy Kong) vs. StreetShark (Sonic) - Wii U RR Pools - CTP2	Video:rZcooShwU1M	Channel:UC_dkX2_MJZeiYZImFN8AOvg
Depth (Samus) vs. Fear (Robin) - Wii U RR Pools - CTP2	Video:-6qC2xPbK2w	Channel:UC_dkX2_MJZeiYZImFN8AOvg
AkashicSword (Greninja) vs. FBC|cE Ookami (Mega Man) - Wii U RR Pools - CTP2	Video:jsj8PsXFoQM	Channel:UC_dkX2_MJZeiYZImFN8AOvg
Captyn (Bowser Jr.) vs. MVG|dyr (Diddy Kong) - Wii U RR Pools - CTP2	Video:j0qAARyI56Y	Channel:UC_dkX2_MJZeiYZImFN8AOvg
KuroKagami (Bayonetta) vs. Tachyon (Pikachu) - Wii U RR Pools - CTP2	Video:nRd-1p5Mlhw	Channel:UC_dkX2_MJZeiYZImFN8AOvg
Depth (Samus) vs. TribaL (Lucas) - Wii U RR Pools - CTP2	Video:NEwf51Jl_Bg	Channel:UC_dkX2_MJZeiYZImFN8AOvg
Zae26 (Rosalina) vs. KuroKagami (Bayonetta) - Wii U RR Pools - CTP2	Video:Hz_lBEAXR_Q	Channel:UC_dkX2_MJZeiYZImFN8AOvg
Seibrik (Meta Knight) vs. G-Rat (Cloud) - Wii U RR Pools - CTP2	Video:W31eSOPe0sU	Channel:UC_dkX2_MJZeiYZImFN8AOvg
KuroKagami (Bayonetta) vs. Brimiq (Game & Watch) - Wii U RR Pools - CTP2	Video:LvXEWHmf6nU	Channel:UC_dkX2_MJZeiYZImFN8AOvg
Zae26 (Kirby) vs. celestialpup (Corrin) - Wii U RR Pools - CTP2	Video:EzHX-fMZhgY	Channel:UC_dkX2_MJZeiYZImFN8AOvg
CrazieCuban (Jigglypuff) vs. ewok41 (Cloud & Lucas) - Wii U RR Pools - CTP2	Video:IuFXIFOM06U	Channel:UC_dkX2_MJZeiYZImFN8AOvg
Noble|Sol (Little Mac) vs. TribaL (Lucas & Ness) - Wii U RR Pools - CTP2	Video:4TcNcM4oBfI	Channel:UC_dkX2_MJZeiYZImFN8AOvg
FBC|Ookami (Mega Man) vs. Vulpae (Palutena) - Wii U RR Pools - CTP2	Video:0h9EVzaXsUE	Channel:UC_dkX2_MJZeiYZImFN8AOvg
Paradise (Peach) vs. AkashicSword (Greninja) - Wii U RR Pools - CTP2	Video:G16N-SGoN0w	Channel:UC_dkX2_MJZeiYZImFN8AOvg
Indigo (Corrin) vs. G-Rat (Cloud) - Wii U RR Pools - CTP2	Video:nLAaBdccHR0	Channel:UC_dkX2_MJZeiYZImFN8AOvg
Pickler (Yoshi) vs. Fatality (Captain Falcon) - Wii U RR Pools - CTP2	Video:8NRGHxQtdGQ	Channel:UC_dkX2_MJZeiYZImFN8AOvg
KuroKagami (Bayonetta) vs. GoTE|4 (Yoshi) - Wii U RR Pools - CTP2	Video:8Z4YkmpyIZ8	Channel:UC_dkX2_MJZeiYZImFN8AOvg
TSF GoblinMan (Roy) vs. BenDover (ROB) - Wii U RR Pools - CTP2	Video:g8ia09Kvb8Q	Channel:UC_dkX2_MJZeiYZImFN8AOvg
BC|Purple Guy (Zelda) vs. Rob (Captain Falcon) - Wii U RR Pools - CTP2	Video:JnaNkzaMsz4	Channel:UC_dkX2_MJZeiYZImFN8AOvg
KidG (Mario) vs. DansFanGaming (Diddy Kong) - Wii U RR Pools - CTP2	Video:jllglCYGn6o	Channel:UC_dkX2_MJZeiYZImFN8AOvg
Brand (ROB) vs. Ecks Dee (Cloud) - Wii U RR Pools - CTP2	Video:JCvBsAnxOL4	Channel:UC_dkX2_MJZeiYZImFN8AOvg
Maverick (VIllager) vs. Skopkin (Kirby) - Wii U RR Pools - CTP2	Video:_fMsnS-URHQ	Channel:UC_dkX2_MJZeiYZImFN8AOvg
Hiro (Mega Man) vs. RoguePenguin (Mario) - Wii U RR Pools - CTP2	Video:uU97VPkrYYc	Channel:UC_dkX2_MJZeiYZImFN8AOvg
Bran (Lucas) vs. BananaJuice (Villager) - Wii U RR Pools - CTP2	Video:qRIBle4Nf0M	Channel:UC_dkX2_MJZeiYZImFN8AOvg
Hiroi (Zero Suit) vs. ATR|Xaltis (Rosalina & Lucina) - Wii U RR Pools - CTP2	Video:209nOX_K5fg	Channel:UC_dkX2_MJZeiYZImFN8AOvg
Crypto (Pit) vs. Mugi (Corrin) - Wii U RR Pools - CTP2	Video:Rw6FvDKYsps	Channel:UC_dkX2_MJZeiYZImFN8AOvg
Jabe (Olimar) vs. Eden (Corrin) - Wii U RR Pools - CTP2	Video:jK6107JUk4I	Channel:UC_dkX2_MJZeiYZImFN8AOvg
Godzillionaire (Bowser) vs. Light (Cloud) - Wii U RR Pools - CTP2	Video:pWqOJU8Fpfo	Channel:UC_dkX2_MJZeiYZImFN8AOvg
Strobics (Game & Watch) vs. DMG.Ross (Toon Link) - Wii U RR Pools - CTP2	Video:lJIVEBCOD5I	Channel:UC_dkX2_MJZeiYZImFN8AOvg
Rob (Captain Falcon) vs. Lein (Corrin) - Wii U RR Pools - CTP2	Video:kayFppQNkkc	Channel:UC_dkX2_MJZeiYZImFN8AOvg
A*G*0* (Captain Falcon) vs. PuffDaddy3 (Greninja) - Wii U RR Pools - CTP2	Video:H2WUlb4cAVo	Channel:UC_dkX2_MJZeiYZImFN8AOvg
BC|Purple Guy (Zelda) vs. KidG (Mario) - Wii U RR Pools - CTP2	Video:8vYySuuOsXc	Channel:UC_dkX2_MJZeiYZImFN8AOvg
DMG.Ross (Toon Link) vs. BananaJuice (Villager) - Wii U RR Pools - CTP2	Video:vp3r9zNt7I8	Channel:UC_dkX2_MJZeiYZImFN8AOvg
Child (Bayonetta) vs. Brand (ROB) - Wii U RR Pools - CTP2	Video:W5DeKkecU4U	Channel:UC_dkX2_MJZeiYZImFN8AOvg
Purple Guy (Zelda) vs. Lein (Corrin) - Wii U RR Pools - CTP2	Video:B6C_-blclas	Channel:UC_dkX2_MJZeiYZImFN8AOvg
Bran (Lucas) vs. Strobics (Game & Watch) - Wii U RR Pools - CTP2	Video:OFZEv9IgUW0	Channel:UC_dkX2_MJZeiYZImFN8AOvg
Maverick (Ryu) vs. ATR|Xaltis (Rosalina) - Wii U RR Pools - CTP2	Video:ST7GyiL5MeE	Channel:UC_dkX2_MJZeiYZImFN8AOvg
G-dub (Toon Link & Marth) vs. Ur2Slow (Sonic) - Wii U RR Pools - TCP2	Video:qB6RqLKiaVI	Channel:UC_dkX2_MJZeiYZImFN8AOvg
double k (Donkey Kong) vs. Hoover (Diddy Kong) - Wii U RR Pools - CTP2	Video:mCiaxpJ_D2o	Channel:UC_dkX2_MJZeiYZImFN8AOvg
Rusty (Ryu) vs. Supernova (Greninja) - Wii U RR Pools - CTP2	Video:WH_eiZ_GUh8	Channel:UC_dkX2_MJZeiYZImFN8AOvg
Kiki (Diddy Kong) vs. Instinct Spark (Sonic) - Wii U RR Pools - CTP2	Video:zQR3UQ9DjhA	Channel:UC_dkX2_MJZeiYZImFN8AOvg
Hoover (Diddy Kong) vs. A.I. (Corrin) - Wii U RR Pools - CTP2	Video:bsdR04GOySg	Channel:UC_dkX2_MJZeiYZImFN8AOvg
COG|Wizzrobe (Sheik) vs. Son (Lucas) - Wii U RR Pools - TCP2	Video:f_2KYz_MIig	Channel:UC_dkX2_MJZeiYZImFN8AOvg
Noble|Ryo (Ike & Roy) vs. BT (Wii Fit) - WII U RR Pools - CTP2	Video:1z24JqZB1qQ	Channel:UC_dkX2_MJZeiYZImFN8AOvg
Riot (Bayonetta) vs. CB|Chez (Sonic) - Wii U RR Pools - CTP2	Video:8A-5pvVbzlc	Channel:UC_dkX2_MJZeiYZImFN8AOvg
FBC|Leo Heart (Mewtwo) vs. J2 (Mewtwo) - Wii U RR Pools) - CTP2	Video:TfiHPe2i170	Channel:UC_dkX2_MJZeiYZImFN8AOvg
Hoover (Diddy Kong) vs. COG|Wizzrobe (Sheik) - Wii U RR Pools - CTP2	Video:iJo9cg7ZEsE	Channel:UC_dkX2_MJZeiYZImFN8AOvg
FBC|Papa Mink (Charizard) vs. Prince Ramen (Palutena) - Wii U RR Pools - CTP2	Video:v1petvQuLEk	Channel:UC_dkX2_MJZeiYZImFN8AOvg
Giant Rat (Sonic & Pit) vs. GoTE|8BitMan (ROB) - Wii U RR Pools - CTP2	Video:QW49h91O6TY	Channel:UC_dkX2_MJZeiYZImFN8AOvg
double k (Donkey & Diddy Kong) vs. Son (Lucas) - Wii U RR Pools - CTP2	Video:FBaVTSm8qd4	Channel:UC_dkX2_MJZeiYZImFN8AOvg
Rematch (Mario & Ryu) vs. Oozma (Mario) - Wii U RR Pools - CTP2	Video:R6S9n_vhnVA	Channel:UC_dkX2_MJZeiYZImFN8AOvg
Duffo (Little Mac) vs. FrankanBean (Shulk) - Wii U RR Pools - CTP2	Video:ZRpHMBrH77g	Channel:UC_dkX2_MJZeiYZImFN8AOvg
G4C|Wonderbread (Little Mac) vs. ScreamoPichu (Cloud) - Wii U RR Pools - CTP2	Video:JGoUSKk-ym0	Channel:UC_dkX2_MJZeiYZImFN8AOvg
Migi (Lucina) vs. Vikikitty (Corrin) - Wii U RR Pools - CTP2	Video:35RUrQoIQz0	Channel:UC_dkX2_MJZeiYZImFN8AOvg
Rocket (Lucina & Cloud) vs. Lime (Lucina & Wii Fit) - Wii U RR Pools - CTP2	Video:vCZwDASLE-M	Channel:UC_dkX2_MJZeiYZImFN8AOvg
T!to (Diddy Kong) vs. Majora (Diddy Kong) - Wii U RR Pools - CTP2	Video:MklWKSAixWs	Channel:UC_dkX2_MJZeiYZImFN8AOvg
FOX|MVG|Mew2King (Cloud) vs. Broom (Cloud) - Wii U RR Pools - CTP2	Video:t6aGQvN8a3o	Channel:UC_dkX2_MJZeiYZImFN8AOvg
Lime (Peach) vs. DJ Jack (Ryu) - Wii U RR Pools - CTP2	Video:b3et5bleGFY	Channel:UC_dkX2_MJZeiYZImFN8AOvg
Bruh (Charizard) vs. Venture (Corrin) - Wii U RR Pools - CTP2	Video:QRoaUgnHTiw	Channel:UC_dkX2_MJZeiYZImFN8AOvg
Poltergust (Yoshi & Link) vs. WonderBread (Little Mac & Mario) - Wii U RR Pools - CTP2	Video:3OG1j3VKGjs	Channel:UC_dkX2_MJZeiYZImFN8AOvg
Shoq|Rideae (Pikachu) vs. Mars WonderBoy (Mario) - Wii U RR Pools - CTP2	Video:khgow8IWp20	Channel:UC_dkX2_MJZeiYZImFN8AOvg
DMG|Ross & Tachyon vs. Noble|Ryo & Noble|Sol - Wii U Doubles Winners Quarters - CTP2	Video:1Ts0MV4G-Us	Channel:UC_dkX2_MJZeiYZImFN8AOvg
MVG|dyr & Fatality vs. Riot & Poltergust - Wii U Doubles Winners Quarters - CTP2	Video:BtCsUik2ph4	Channel:UC_dkX2_MJZeiYZImFN8AOvg
Paradise & Kino vs. Prince Ramen & FOX|MVG|Mew2King - Wii U Doubles Winners R3 - CTP2	Video:57n2WF6cDjA	Channel:UC_dkX2_MJZeiYZImFN8AOvg
Noble|Sol & Noble|Ryo vs. True Blue & Seibrek - Wii U Doubles Winners R3 - CTP2	Video:E-mdgJFAEPc	Channel:UC_dkX2_MJZeiYZImFN8AOvg
Instinct|Spark & VexX|Day vs. Port & GoTE|8BitMan - Wii U Doubles Winners R2 - CTP2	Video:fLqnzSg6bOo	Channel:UC_dkX2_MJZeiYZImFN8AOvg
Fatality & MVG|dyr vs. Mugi & Shoq|Rideae - Wii U Doubles Winners R2 -  CTP2	Video:aXkrIWxGa_4	Channel:UC_dkX2_MJZeiYZImFN8AOvg
Come to Papa 2 Broadcast Day 1	Video:p9zC5oJ8yVE	Channel:UC_dkX2_MJZeiYZImFN8AOvg
Samus In Depth Moveset and Competitive Guide (Salem) - Super Smash Bros. Wii U	Video:_G8BLrxvgS4	Channel:UC_dkX2_MJZeiYZImFN8AOvg
Vote WizZy for Smash Summit 3! part 2	Video:NSaI3mtcBJI	Channel:UC_dkX2_MJZeiYZImFN8AOvg
Wizzrobe tries Milk & Cookies for the 1st TIME!	Video:UQLXFQ9jxHg	Channel:UC_dkX2_MJZeiYZImFN8AOvg
Can Mew2King Chain Grab without Seeing Characters??	Video:UEO-ogbAhwo	Channel:UC_dkX2_MJZeiYZImFN8AOvg
Smash 4 & Melee at the Office ft. M2K, Salem, WizZy & CherubiKnighT	Video:6PgWtqJtO4s	Channel:UC_dkX2_MJZeiYZImFN8AOvg
MVG|Salem Interview - Smash Conference 68	Video:XH1NwbcNkKE	Channel:UC_dkX2_MJZeiYZImFN8AOvg
Vote WizZy for Smash Summit 3!	Video:6Ihb3nnmtS4	Channel:UC_dkX2_MJZeiYZImFN8AOvg
Instinct Spark Interview - Smash Conference 68	Video:dHQ7aqci38w	Channel:UC_dkX2_MJZeiYZImFN8AOvg
Instinct Spark (Sonic) vs. MVG|Salem (Bayonetta) - Wii U Grand Finals - SC:68	Video:t1PfJ5uL-NM	Channel:UC_dkX2_MJZeiYZImFN8AOvg
7S|Saj (Bayonetta) vs. MVG|Salem (Bayonetta) - Wii U Losers Finals - SC:68	Video:Mz7w84o9IGc	Channel:UC_dkX2_MJZeiYZImFN8AOvg
MVG|Salem (Bayonetta) vs. GoTE|8BitMan (ROB) - Wii U Losers Semis - SC:68	Video:2ZGmm5twras	Channel:UC_dkX2_MJZeiYZImFN8AOvg
Instinct Spark (Sonic) vs. 7S|Saj (Bayonetta) - Wii U Winner's Finals - SC:68	Video:2YE4SDYVHZ0	Channel:UC_dkX2_MJZeiYZImFN8AOvg
GoTE|8BitMan (ROB) vs. MVG|dyr (Diddy Kong) - Wii U Losers Quarters - SC:68	Video:AJ2J-OUQRUI	Channel:UC_dkX2_MJZeiYZImFN8AOvg
DMG Lord Mix (Bowser) vs. Instinct Spark (Sonic) - Wii U Winner's Semis - SC:68	Video:Rn1Trd-Ljvs	Channel:UC_dkX2_MJZeiYZImFN8AOvg
GoTE|8BitMan (ROB) vs. 7S|Saj (Bayonetta) - Wii U Winner's Semis - SC:68	Video:S00l_jBHnNA	Channel:UC_dkX2_MJZeiYZImFN8AOvg
DMG Lord Mix (Bowser) vs. FOX MVG|Mew2King (Cloud) - Wii U Winner's Quarters - SC:68	Video:w6G5LEp8h20	Channel:UC_dkX2_MJZeiYZImFN8AOvg
MVG|Salem (Bayonetta) vs. 7S|Saj (Bayonetta) - Wii U Winner's Quarters - SC:68	Video:UEmf9J6IWPk	Channel:UC_dkX2_MJZeiYZImFN8AOvg
FOX MVG|Mew2King (Red) vs. PG|Plup (Green) - Melee Grand Finals - SC:68	Video:wCk9jES4oc4	Channel:UC_dkX2_MJZeiYZImFN8AOvg
GoTE|8BitMan (ROB) vs. Shoq|Rideae (Pikachu & Sheik) - Wii U Winner's Quarters - SC:68	Video:m8qFKi9Nt5M	Channel:UC_dkX2_MJZeiYZImFN8AOvg
FOX MVG|Mew2King (Sheik, Pichu, G&W) vs. MrLz (G&W) - Melee Loser's Finals - SC:68	Video:_-4IXvrRnr8	Channel:UC_dkX2_MJZeiYZImFN8AOvg
FOX MVG|Mew2King (Blue) vs. PG|Plup (Green) - Melee Winner's Finals - SC:68	Video:2vUzeg69kmo	Channel:UC_dkX2_MJZeiYZImFN8AOvg
FBC Leo Heart (Mewtwo) vs. The Gount (Ryu) - Wii U Winner's Bracket - SC:68	Video:9jApy1OXrmw	Channel:UC_dkX2_MJZeiYZImFN8AOvg
7S|Saj (Bayonetta) vs. MVG|dyr (Diddy Kong) - Wii U Winner's Bracket - SC:68	Video:ppZw-zQnueI	Channel:UC_dkX2_MJZeiYZImFN8AOvg
MrLz (Marth & Game & Watch) vs. Sinbad (Sheik) - Melee Loser's Semis - SC:68	Video:wQXx4l1mxQk	Channel:UC_dkX2_MJZeiYZImFN8AOvg
DMG LordMix (Bowser) vs. Prince Ramen (Palutena) - Wii Winner's Bracket - SC:68	Video:LMqK-FGTJxk	Channel:UC_dkX2_MJZeiYZImFN8AOvg
GoTE|8BitMan (ROB) vs. Yld (Villager) - Wii U Winner's Bracket - SC:68	Video:OOePv3uo1w8	Channel:UC_dkX2_MJZeiYZImFN8AOvg
Riot (Bayonetta) vs. UtopianRay (Rosalina) - Wii U Winner's Bracket - SC:68	Video:Q6jTtwwWY3E	Channel:UC_dkX2_MJZeiYZImFN8AOvg
MVG|Salem & FOX MVG|Mew2King vs. Oni Spark & VexX|Oni Day - Doubles Grand Finals - SC:68	Video:ryDa1mls71o	Channel:UC_dkX2_MJZeiYZImFN8AOvg
MVG|Salem & FOX MVG|Mew2King vs. Ross & Tachyon - Doubles Losers Finals - SC:68	Video:xBy6Tg3KlwU	Channel:UC_dkX2_MJZeiYZImFN8AOvg
Shoq|Rideae & Cashmere vs. Ross & Tachyon - Doubles Losers Semis - SC:68	Video:b6ld9vblHpU	Channel:UC_dkX2_MJZeiYZImFN8AOvg
VexX|Oni Day & Oni Spark vs. FOX MVG|Mew2King & MVG|Salem - Doubles Winners Finals - SC:68	Video:YZnWUOw9pfs	Channel:UC_dkX2_MJZeiYZImFN8AOvg
Xmas & Zeta vs. Leo Heart & 7S|Saj - Doubles Losers Top 8 - SC:68	Video:nQt4CUQGEUM	Channel:UC_dkX2_MJZeiYZImFN8AOvg
Port & GoTE|8BitMan vs. Ross & Tachyon - Doubles Losers Top 8 - SC:68	Video:FgSF291EGHI	Channel:UC_dkX2_MJZeiYZImFN8AOvg
Cashmere & Rideae vs. FOX MVG|Mew2King & MVG|Salem - Doubles Winners Semis - SC:68	Video:A84k0VgkSSY	Channel:UC_dkX2_MJZeiYZImFN8AOvg
Oni Spark & VexX|Oni Day vs. LordMix & Riot - Doubles Winners Bracket - SC:68	Video:W0aDKDBPGl0	Channel:UC_dkX2_MJZeiYZImFN8AOvg
Oni Spark & VexX|Oni Day vs. Duffo & Ookami - Doubles Winners Bracket - SC:68	Video:gEOCy02ImJc	Channel:UC_dkX2_MJZeiYZImFN8AOvg
LordMix & Riot vs. Leo Heart & 7S|Saj - Doubles Winners Bracket - SC:68	Video:xYbRI1jlKDc	Channel:UC_dkX2_MJZeiYZImFN8AOvg
Asmodemous & MVG|CherubiKnighT vs. MVG|Salem & FOX MVG|Mew2King - Doubles Winners Bracket - SC:68	Video:868UAMtDKjU	Channel:UC_dkX2_MJZeiYZImFN8AOvg
Smash Conference 68 broadcast	Video:oau-JAkpGXY	Channel:UC_dkX2_MJZeiYZImFN8AOvg
Mew2King's Pichu SECRET Tech Revealed	Video:mQVL4jO31NU	Channel:UC_dkX2_MJZeiYZImFN8AOvg
M2K Melee Shenanigans ft. Harriet	Video:Lhg1_oAKr7k	Channel:UC_dkX2_MJZeiYZImFN8AOvg
Wizzrobe said WHAT?!!!	Video:nl5DcKUrZrs	Channel:UC_dkX2_MJZeiYZImFN8AOvg
M2K Office Stream ft. Mew2King, Gahtzu WizZy & Mr. Lz	Video:3JBeXyxbyL8	Channel:UC_dkX2_MJZeiYZImFN8AOvg
Melee Netplay Day 2 ft. Mew2King & Plup	Video:R7KB4VAmNVk	Channel:UC_dkX2_MJZeiYZImFN8AOvg
Melee Netplay ft. Mew2King	Video:HlFu2uEW2JI	Channel:UC_dkX2_MJZeiYZImFN8AOvg
CT|Salem (Bayonetta) vs. FOX MVG|Mew2King (Cloud) - Wii U Grand Finals - SC:67	Video:WKHKkequPT8	Channel:UC_dkX2_MJZeiYZImFN8AOvg
MVG|dyr (Diddy & Cloud) vs. FOX MVG|Mew2King (Cloud) - Wii U Losers Finals - SC:67	Video:3ZQJb-ek9yA	Channel:UC_dkX2_MJZeiYZImFN8AOvg
CT|Salem (Bayonetta) vs. FOX MVG|Mew2King (Cloud) - Wii U Winners Finals - SC:67	Video:PdIyIvUJQwQ	Channel:UC_dkX2_MJZeiYZImFN8AOvg
MVG|dyr (Diddy Kong) vs. Instinct Spark (Sonic) - Wii U Losers Quarters - SC:67	Video:8K1eU5HsJIA	Channel:UC_dkX2_MJZeiYZImFN8AOvg
Instinct Spark (Sonic) vs. FOX MVG|Mew2King (Cloud) - Wii U Winners Semis - SC:67	Video:AOgFKZiopGs	Channel:UC_dkX2_MJZeiYZImFN8AOvg
CT|Salem (Bayonetta) vs. Fatality (Mario & C. Falcon) - Wii U Winners Semis - SC:67	Video:dGT53zLOI3s	Channel:UC_dkX2_MJZeiYZImFN8AOvg
FOX MVG|Mew2King (Cloud) vs. VexX|Oni Day (Lucario) - Wii U Winners Quarters - SC:67	Video:Cj3xiC6HEBw	Channel:UC_dkX2_MJZeiYZImFN8AOvg
Prince Ramen (Palutena) vs. Fatality (C. Falcon) - Wii U Winners Quarters - SC:67	Video:sQ-8oSaAxXk	Channel:UC_dkX2_MJZeiYZImFN8AOvg
FOX MVG|Mew2King (Pichu & Marth) vs. Barraca (Marth & G&W) - Melee Grand Finals - SC:67	Video:7t8B5oq0DmI	Channel:UC_dkX2_MJZeiYZImFN8AOvg
MVG|dyr (Diddy Kong) vs. CT|Salem (Bayonetta) - Wii U Winners Quarters - SC:67	Video:fcoUE_WZyXA	Channel:UC_dkX2_MJZeiYZImFN8AOvg
Barraca (Marth) vs. Sinbad (Sheik) - Melee Losers Finals - SC:67	Video:iKVcGFd_lwA	Channel:UC_dkX2_MJZeiYZImFN8AOvg
Instinct Spark (Sonic) vs. MVG|ScAtt (Mega Man) - Wii U Winners Bracket - SC:67	Video:1Ahf9EmwZGI	Channel:UC_dkX2_MJZeiYZImFN8AOvg
Barraca (Marth) vs. Oppa (Peach) - Melee Losers Semis - SC:67	Video:lU_a1sr2u90	Channel:UC_dkX2_MJZeiYZImFN8AOvg
RoguePenguin (Mario) vs. Fatality (C. Falcon) - Wii U Winners Bracket - SC:67	Video:Rk4L8g6-Q8I	Channel:UC_dkX2_MJZeiYZImFN8AOvg
Mugi (Corrin) vs. MVG|ScAtt (Mega Man) - Wii U Winners Bracket - SC:67	Video:J7wh6m5Mab0	Channel:UC_dkX2_MJZeiYZImFN8AOvg
FOX MVG|Mew2King (Sheik) vs. Sinbad (Sheik) - Melee Winners Finals - SC:67	Video:jdjprSPFe-0	Channel:UC_dkX2_MJZeiYZImFN8AOvg
Hex (Yoshi) vs. Fatality (C. Falcon) - Wii U Winners Bracket - SC:67	Video:2M9Bg2a0hEQ	Channel:UC_dkX2_MJZeiYZImFN8AOvg
Xmas (Shulk) vs. MVG|ScAtt (Mega Man) - Wii U Winners Bracket - SC:67	Video:aaCqJ3FVV50	Channel:UC_dkX2_MJZeiYZImFN8AOvg
Barraca (Marth) vs. [FBC] Lad (Fox) - Melee Losers Quarters - SC:67	Video:aqQcntwdF2o	Channel:UC_dkX2_MJZeiYZImFN8AOvg
CT|Salem (Lucina) vs. ewok41 (Lucas & Cloud) - Wii U Winners Bracket - SC:67	Video:v2Ki8pIUx4o	Channel:UC_dkX2_MJZeiYZImFN8AOvg
Oppa (Peach) vs. Christian (Link) - Melee Losers Quarters - SC:67	Video:16XlnRIntR4	Channel:UC_dkX2_MJZeiYZImFN8AOvg
Cashmere (C.Falcon) vs. JaK (Diddy Kong) - Wii U Winners Bracket - SC:67	Video:8LpmQbeCpT4	Channel:UC_dkX2_MJZeiYZImFN8AOvg
Kenpachi (Fox) vs. [FBC] Lad (Fox) - Melee Losers Eighths - SC:67	Video:1G_Jx4G6xR8	Channel:UC_dkX2_MJZeiYZImFN8AOvg
MVG|ScAtt & Fatality vs. CT|Salem & FOX MVG|Mew2King - Wii U Doubles Grand Finals - SC:67	Video:qlXsVZKvplQ	Channel:UC_dkX2_MJZeiYZImFN8AOvg
Christian (Link) vs. Nohgrilla (Donkey Kong & Sheik) - Melee Losers Eighths - SC:67	Video:bTFFAHH5WC8	Channel:UC_dkX2_MJZeiYZImFN8AOvg
MVG|ScAtt & Fatality vs. VexX|Oni Day & Spark - Wii U Doubles Losers Finals - SC:67	Video:hFB2HqWsYlk	Channel:UC_dkX2_MJZeiYZImFN8AOvg
Sinbad (Sheik) vs. Barraca (Marth) - Melee Winners Semis - SC:67	Video:4IJLhAZ1xWs	Channel:UC_dkX2_MJZeiYZImFN8AOvg
FOX MVG|Mew2King (Sheik & Marth) vs. Oppa (Peach) - Melee Winners Semis - SC:67	Video:bKOJcktpJdo	Channel:UC_dkX2_MJZeiYZImFN8AOvg
MVG|ScAtt & Fatality vs. JaK & MVG|dyr - Wii U Doubles Losers Semis - SC:67	Video:OjkdfEVGPdA	Channel:UC_dkX2_MJZeiYZImFN8AOvg
Barraca (Marth) vs. Nohgrilla (Donkey Kong) - Melee Winners R3 - SC:67	Video:E8FG8MFJDwk	Channel:UC_dkX2_MJZeiYZImFN8AOvg
MVG|ScAtt & Fatality vs. Dath & TrueBlue - Wii U Doubles Losers Quarters - SC:67	Video:9Qvgh9an94o	Channel:UC_dkX2_MJZeiYZImFN8AOvg
Oppa (Peach) vs. [FBC] Ladd (Fox) - Melee Winners R3 - SC:67	Video:6HfXPJQum2o	Channel:UC_dkX2_MJZeiYZImFN8AOvg
Sinbad (Sheik) vs. Christian (Link) - Melee Winners R3 - SC:67	Video:bq53gjr2ZfE	Channel:UC_dkX2_MJZeiYZImFN8AOvg
CT|Salem & FOX MVG|Mew2King vs. VexX| Oni Day & Spark - Wii U Doubles Winners Finals - SC:67	Video:1IMN695AxQU	Channel:UC_dkX2_MJZeiYZImFN8AOvg
Kenpachi (Fox) vs. Rayd (C. Falcon) - Melee Winners R2 - SC:67	Video:eodsy_x9BL8	Channel:UC_dkX2_MJZeiYZImFN8AOvg
Barraca (Marth) vs. Nelk (Jigglypuff) - Wii U Winners R2 - SC:67	Video:hPLODI1Is7k	Channel:UC_dkX2_MJZeiYZImFN8AOvg
Sinbad & Oppa vs. Nohgrilla & Kenpachi - Melee Doubles Grand Finals - SC:67	Video:oX-ixItMQ34	Channel:UC_dkX2_MJZeiYZImFN8AOvg
Lad & Yobe vs. Nohgrilla & Kenpachi - Melee Doubles RR - SC:67	Video:DjH4W_C3hNA	Channel:UC_dkX2_MJZeiYZImFN8AOvg
Lad & Yobe vs. Tru & Neat - Melee Doubles RR - SC:67	Video:XZ42MbgEgYY	Channel:UC_dkX2_MJZeiYZImFN8AOvg
SunshineStateFishing & Nelk vs. Sinbad & Oppa - Melee Doubles RR - SC:67	Video:247m5aabdKE	Channel:UC_dkX2_MJZeiYZImFN8AOvg
Salem & FOX MVG|Mew2King vs. 7S|Saj & CrazieCuban - Wii U Doubles Winners - SC:67	Video:Kkn5fP4UJ3I	Channel:UC_dkX2_MJZeiYZImFN8AOvg
Kenpachi & Nohgrilla vs. SunshineStateFishing & Nelk - Melee Doubles RR - SC:67	Video:314Yhg0l1eY	Channel:UC_dkX2_MJZeiYZImFN8AOvg
Tru & Neat vs. SunshineStateFishing & Nelk - Melee Doubles RR - SC:67	Video:-yywRA6oLL0	Channel:UC_dkX2_MJZeiYZImFN8AOvg
Sinbad & Oppa vs. Lad & Yobe - Melee Doubles RR - SC:67	Video:9efWjIE9-g0	Channel:UC_dkX2_MJZeiYZImFN8AOvg
Nohgrilla & Kenpachi vs. Tru & Neat - Melee Doubles RR - SC:67	Video:47p24OHy17M	Channel:UC_dkX2_MJZeiYZImFN8AOvg
Nelk & SunshineStateFishing vs. Lad & Yobe - Melee Doubles RR - SC67	Video:AlvEejg87Rg	Channel:UC_dkX2_MJZeiYZImFN8AOvg
FOX MVG|Mew2King (Cloud) vs. VexX|Oni Day (Lucario) - Wii U Grand Finals - SC: LXVI	Video:A7I8bCfrsoM	Channel:UC_dkX2_MJZeiYZImFN8AOvg
FBC|Leo Heart (Mewtwo) vs. VexX|Oni Day (Lucario) - Wii U Loser's Finals - SC: LXVI	Video:60FL_MGUx4c	Channel:UC_dkX2_MJZeiYZImFN8AOvg
FOX MVG|Mew2King (Cloud) vs. VexX|Oni Day (Lucario) - Wii U Winner's Finals - SC: LXVI	Video:aGhwCesZdoI	Channel:UC_dkX2_MJZeiYZImFN8AOvg
VexX|Oni Day & Spark vs. FOX MVG|Mew2King & MVG|Dyr - Wii U Doubles Grand Finals - SC: LXVI	Video:5BFhwUessj4	Channel:UC_dkX2_MJZeiYZImFN8AOvg
Mugi & Yld vs. FOX MVG|Mew2King & MVG|Dyr - Wii U Doubles Loser's Finals - SC: LXVI	Video:PP6hzbtJu9g	Channel:UC_dkX2_MJZeiYZImFN8AOvg
FOX MVG|Mew2King (Sheik) vs. PG|Plup (Sheik) - Melee Grand Finals - SC: LXVI	Video:0Cl32X07Moc	Channel:UC_dkX2_MJZeiYZImFN8AOvg
FOX MVG|Mew2King (Sheik & Marth) vs. Pengie (Fox) - Melee Loser's Finals - SC: LXVI	Video:lyRI9IaYOOk	Channel:UC_dkX2_MJZeiYZImFN8AOvg
MVG|Dyr (Diddy) vs. FBC|Leo Heart (Mewtwo) - Wii U Loser's Semis - SC: LXVI	Video:0r23hhdhcwg	Channel:UC_dkX2_MJZeiYZImFN8AOvg
Gahtzu (C. Falcon) vs. Pengie (Fox) - Melee Losers Semis - SC: LXVI	Video:gK0UMVpfpzU	Channel:UC_dkX2_MJZeiYZImFN8AOvg
Shoq|Rideae (Pikachu) vs. MVG|Dyr (Diddy) - Wii U Loser's Quarters - SC: LXVI	Video:Pq2ljx0Uqqs	Channel:UC_dkX2_MJZeiYZImFN8AOvg
FOX MVG|Mew2King (Sheik & Marth) vs. PG|Plup (Sheik) - Melee Winner's Finals - SC: LXVI	Video:0pr5NgdfVjI	Channel:UC_dkX2_MJZeiYZImFN8AOvg
Prince Ramen (Palutena) vs. MVG|Dyr (Diddy) - Loser's Eighths - SC: LXVI	Video:Esv0yh9EUS8	Channel:UC_dkX2_MJZeiYZImFN8AOvg
Gahtzu (C. Falcon) vs. Harriet (Fox) - Melee Loser's Quarters - SC: LXVI	Video:3ovLk-vMXrA	Channel:UC_dkX2_MJZeiYZImFN8AOvg
FBC|Leo Heart (Mewtwo) vs. Spark (Sonic & Roy) - Wii U Loser's Bracket - SC: LXVI	Video:BezlU66mwto	Channel:UC_dkX2_MJZeiYZImFN8AOvg
FOX MVG|Mew2King (Sheik) vs. Gahtzu (C. Falcon) - Melee Winner's Semis - SC: LXVI	Video:DPPXVsgcVwM	Channel:UC_dkX2_MJZeiYZImFN8AOvg
Prince Ramen (Palutena) vs. Yucas (Fox) - Wii U Loser's Bracket - SC: LXVI	Video:4B1VvezOoDY	Channel:UC_dkX2_MJZeiYZImFN8AOvg
DaShizWiz (Falco) vs. PG|Plup (Sheik) - Melee Winner's Semis - SC: LXVI	Video:LbX_RMVBc8c	Channel:UC_dkX2_MJZeiYZImFN8AOvg
FOX MVG|Mew2King (Cloud) vs. Shoq|Rideae (Pikachu) - Wii U Winner's Semi's - SC: LXVI	Video:8_DY8nrp82Y	Channel:UC_dkX2_MJZeiYZImFN8AOvg
SFS|A Rookie (Mario) vs. Harriet (Fox) - Melee Loser's Eighths - SC: LXVI	Video:D_YNfvsPzsw	Channel:UC_dkX2_MJZeiYZImFN8AOvg
Pengie (Falco) vs. Kaike (Fox) - Melee Loser's Eighths - SC: LXVI	Video:sMcg_yE43x4	Channel:UC_dkX2_MJZeiYZImFN8AOvg
VexX|Oni Day (Lucario) vs. Spark (Mario) - Wii U Winner's Semis - SC: LXVI	Video:5SpZNp-Nl8Q	Channel:UC_dkX2_MJZeiYZImFN8AOvg
Harriet (Green Fox) vs. [FBC] Lad (Red Fox) - Melee Loser's R4 - SC: LXVI	Video:iv56XWrmrWY	Channel:UC_dkX2_MJZeiYZImFN8AOvg
VexX|Oni Day (Lucario) vs. MVG|Dyr (Diddy) - Wii U Winner's - SC: LXVI	Video:IrfbFfeGoiQ	Channel:UC_dkX2_MJZeiYZImFN8AOvg
[FBC] Lad (Fox) vs. BiggPappa (Ganondorf) - Melee Loser's R3 - SC: LXVI	Video:4qSMH7IeedE	Channel:UC_dkX2_MJZeiYZImFN8AOvg
FOX MVG| Mew2King (Sheik & Marth) vs. Oaty (Peach) - Melee Winner's Quarters - SC: LXVI	Video:qmQ-h28hy6Q	Channel:UC_dkX2_MJZeiYZImFN8AOvg
MrLz (G&W & Fox) vs. PG|Plup (Sheik) - Melee Winner's Quarters - SC: LXVI	Video:MCFm0s6jQGk	Channel:UC_dkX2_MJZeiYZImFN8AOvg
DaShizWiz (Falco) vs. Harriet (Fox) - Melee Winner's R3 - SC: LXVI	Video:zo9MyQ_Z7Cs	Channel:UC_dkX2_MJZeiYZImFN8AOvg
DChainz|Aly (Marth) vs. DaShizWiz (Falco) - Melee Winner's R2 - SC: LXVI	Video:bHc8bYYtWUg	Channel:UC_dkX2_MJZeiYZImFN8AOvg
FOX MVG|Mew2King (Sheik) vs. Ober (Falco) - Melee Winner's R2 - SC: LXVI	Video:p_4CzfpJCtA	Channel:UC_dkX2_MJZeiYZImFN8AOvg
Pengie & Kike vs. PG|Plup & Gahtzu - Melee Doubles Grand Finals - SC:LXVI	Video:z46YIeurN-U	Channel:UC_dkX2_MJZeiYZImFN8AOvg
Mew2King tries out Marth - Smash Wii U	Video:l0j3Mff-_vw	Channel:UC_dkX2_MJZeiYZImFN8AOvg
Vexx|Oni Day (Lucario) vs. StaticManny (Fox) - Grand Finals - SC66	Video:Bz3FOxmUZb4	Channel:UC_dkX2_MJZeiYZImFN8AOvg
Noble|Ryo (Roy & Corrin) vs. StaticManny (Fox & Sonic) - Losers Finals - SC66	Video:EHPtvAkalXk	Channel:UC_dkX2_MJZeiYZImFN8AOvg
Noble|Ryo (Corrin) vs. GF|RoguePenguin (Mario) - Losers Quarters - SC66	Video:YmgIHufLmpA	Channel:UC_dkX2_MJZeiYZImFN8AOvg
Noble|Ryo (Ike) vs. BlitzKinG (Little Mac) - Losers Semis - SC66	Video:q57a--C8GA4	Channel:UC_dkX2_MJZeiYZImFN8AOvg
Vexx|Oni Day (Lucario) vs. StaticManny (Sonic, Fox, & Roy) - Winners Finals - SC66	Video:IDqKyt6cRds	Channel:UC_dkX2_MJZeiYZImFN8AOvg
Arctic Fox (Fox) vs. GF|RoguePenguin (Mario) - Losers R6 - SC66	Video:ZngtI_DcSZg	Channel:UC_dkX2_MJZeiYZImFN8AOvg
TNM Hyperlink (Toon Link) vs. GF|RoguePenguin (Mario) - Losers R5 - SC66	Video:hwZ4GHilo40	Channel:UC_dkX2_MJZeiYZImFN8AOvg
PK Kid (Ness) vs. WonderBread (Little Mac) - Losers R6 - SC66	Video:duwjnYMSfTU	Channel:UC_dkX2_MJZeiYZImFN8AOvg
Vexx|Oni Day (Lucario) vs. BlitzKinG (Little Mac) - Winners Semis - SC66	Video:zlKrIa3nKbg	Channel:UC_dkX2_MJZeiYZImFN8AOvg
Noble|Ryo (Little Mac) vs. StaticManny (Fox) - Winners Semis - SC66	Video:pcbskJ1vmfI	Channel:UC_dkX2_MJZeiYZImFN8AOvg
Vexx|Oni Day (Lucario) vs. GF|RoguePenguin (Mario) - Winners R4 - SC66	Video:egW7xDuBPcs	Channel:UC_dkX2_MJZeiYZImFN8AOvg
StaticManny (Roy) vs. WonderBread (Little Mac) - Winners R4 - SC66	Video:7OWqPt2p26Y	Channel:UC_dkX2_MJZeiYZImFN8AOvg
BlitzKinG (Little Mac) vs. Artic Fox (Fox) - Winners R4 - SC66	Video:Juf-QIn_Nno	Channel:UC_dkX2_MJZeiYZImFN8AOvg
Vexx|Oni Day (Lucario) vs. Slingz (Villager) - Winners R3 - SC66	Video:LM0sDLrHGWc	Channel:UC_dkX2_MJZeiYZImFN8AOvg
7S|Saj & CrazieCuban vs. Noble|Ryo & StaticManny - Doubles Grand Finals - SC66	Video:Bb-LJ0gEpGo	Channel:UC_dkX2_MJZeiYZImFN8AOvg
Smitheyyy & WonderBread vs. Noble|Ryo & StaticManny - Doubles Losers Finals - SC66	Video:UdfSf9G8auE	Channel:UC_dkX2_MJZeiYZImFN8AOvg
Smitheyyy & WonderBread vs. SnarkieFox & RoguePenguin - Doubles Losers Semis - SC66	Video:LVFnEwlwJVE	Channel:UC_dkX2_MJZeiYZImFN8AOvg
TNM Bruh & TNM Hyperlink vs. SnarkieFox & RoguePenguin - Doubles Losers Quarters - SC66	Video:OaNVTRFO2Hw	Channel:UC_dkX2_MJZeiYZImFN8AOvg
7S|Saj & CrazieCuban vs. Noble|Ryo & StaticManny - Doubles Winners Finals - SC66	Video:C-qAzTffOtM	Channel:UC_dkX2_MJZeiYZImFN8AOvg
7S|Saj & CrazieCuban vs. Smitheyyy & WonderBread - Doubles Winners Semis - SC66	Video:gykLuEUoVok	Channel:UC_dkX2_MJZeiYZImFN8AOvg
Hyrule Temple Hijinks	Video:RYisuPx2iG4	Channel:UC_dkX2_MJZeiYZImFN8AOvg
5 Player Fun on Palutena's Temple!	Video:OWandEhdfG8	Channel:UC_dkX2_MJZeiYZImFN8AOvg
Mew2King (Cloud) vs. CherubiKnighT (Lucina) - Friendly Matches	Video:p890_f2FUq4	Channel:UC_dkX2_MJZeiYZImFN8AOvg
FOX MVG|Mew2King (Cloud) vs. Cashmere (C. Falcon) - Grand Finals - SC65	Video:StnqyDVQTqM	Channel:UC_dkX2_MJZeiYZImFN8AOvg
Ryo (Corrin, Roy, & Ike) vs. Cashmere (C. Falcon) - Losers Finals - SC65	Video:g6Z6v26Mmg8	Channel:UC_dkX2_MJZeiYZImFN8AOvg
Ryo (Roy & Corrin) vs. VexX|Oni Day (Lucario) - Losers Semis - SC65	Video:yUZUS9V6lig	Channel:UC_dkX2_MJZeiYZImFN8AOvg
Cashmere (C. Falcon) vs. FOX MVG|Mew2King (Cloud) - Winners Finals - SC65	Video:fTTqFomX9LQ	Channel:UC_dkX2_MJZeiYZImFN8AOvg
DewDaDash (Diddy & Cloud) vs. VexX Oni|Day (Lucario) - Losers Quarters - SC65	Video:4VrG3Q13aD0	Channel:UC_dkX2_MJZeiYZImFN8AOvg
Ryo (Ike & Corrin) vs. Shoq|Rideae (Pikachu) - Losers Quarters - SC65	Video:v6hPru8cJLM	Channel:UC_dkX2_MJZeiYZImFN8AOvg
Ryo (Corrin & Roy) vs. Cashmere (C. Falcon) - Winners Semis - SC65	Video:IlxRhMmcHSM	Channel:UC_dkX2_MJZeiYZImFN8AOvg
FOX MVG|Mew2King (Cloud) vs. VexX|Oni Day (Lucario) - Winners Semis - SC65	Video:qBy-rLFq53A	Channel:UC_dkX2_MJZeiYZImFN8AOvg
Cashmere (C. Falcon) vs. RoguePenguin (Mario) - Winners R4 - SC65	Video:fV5izp2YX9c	Channel:UC_dkX2_MJZeiYZImFN8AOvg
Ryo (Corrin) vs. Noble|Sol (Little Mac) - Winners R4 - SC65	Video:qpgARIfxSQI	Channel:UC_dkX2_MJZeiYZImFN8AOvg
VexX Oni|Day (Lucario) vs. Shoq|Rideae (Pikachu) - Winners R4 - SC65	Video:QK3KuNJrmHQ	Channel:UC_dkX2_MJZeiYZImFN8AOvg
WonderBread (Little Mac) vs. Fox MVG|Mew2King (Cloud) - Winners R4 - SC65	Video:5mnr3pjOeMg	Channel:UC_dkX2_MJZeiYZImFN8AOvg
BlitzKinG (Little Mac) vs. Cashmere (C. Falcon) - Winners R3 - SC65	Video:_offraJoS6Y	Channel:UC_dkX2_MJZeiYZImFN8AOvg
7 (Link) vs. Shoq|Rideae (Pikachu) - Winners R3 - SC65	Video:fwrbjbyOMCg	Channel:UC_dkX2_MJZeiYZImFN8AOvg
Ryo & Noble|Sol vs. Shoq|Rideae & Cashmere - Doubles Grand Finals - SC65	Video:yVOLY7HLwW0	Channel:UC_dkX2_MJZeiYZImFN8AOvg
Ryo & Noble|Sol vs. Saj & CrazieCuban - Doubles Losers Finals - SC65	Video:XROYWnAMPFA	Channel:UC_dkX2_MJZeiYZImFN8AOvg
Ryo & Noble|Sol vs. Cashmere & Shoq|Rideae - Doubles Winners Finals - SC65	Video:JbIVRT6ZwtI	Channel:UC_dkX2_MJZeiYZImFN8AOvg
Mew2King and Dabuz SWITCH MAINS	Video:XvSjSLhOZ88	Channel:UC_dkX2_MJZeiYZImFN8AOvg
Mew2King's Mewtwo vs. RoguePenguin (Mario)	Video:Ixa-XhxLVMA	Channel:UC_dkX2_MJZeiYZImFN8AOvg
7S|Saj (Peach, ZSS, & Bayonetta) vs. RoguePenguin (Mario) - Grand Finals - SC64	Video:S5qKfBJ-574	Channel:UC_dkX2_MJZeiYZImFN8AOvg
MVG|Ryo (Villager & Ike) vs. RoguePenguin (Mario) - Losers Finals - SC64	Video:d8F4G69iU6Y	Channel:UC_dkX2_MJZeiYZImFN8AOvg
Cashmere (C. Falcon) vs. RoguePenguin (Mario) - Losers Semis - SC64	Video:d49UcsMMEwA	Channel:UC_dkX2_MJZeiYZImFN8AOvg
Cashmere (C.Falcon) vs. Duffo (Little Mac) - Losers Quarters - SC64	Video:jCR6W6gzjYY	Channel:UC_dkX2_MJZeiYZImFN8AOvg
7S|Saj (Peach, ZSS, & Link) vs. MVG|Ryo (Little Mac, Samus, Roy, & Doctor) - Winners Finals - SC64	Video:yySImSDwsxA	Channel:UC_dkX2_MJZeiYZImFN8AOvg
7S|Saj (Peach) vs. Noble|Sol (Little Mac) - Winners Semis - SC64	Video:S8Qe7RO2t1s	Channel:UC_dkX2_MJZeiYZImFN8AOvg
Cashmere (C.Falcon) vs. MVG|Ryo (C.Falcon & Roy) - Winners Semis - SC64	Video:6orbowB5PbA	Channel:UC_dkX2_MJZeiYZImFN8AOvg
Depth (Samus) vs. 7S|Saj (Peach) - Winners Quarters - SC64	Video:zd2SA3Ke0dc	Channel:UC_dkX2_MJZeiYZImFN8AOvg
Duffo (Wii Fit & Little Mac) vs. Noble|Sol (Little Mac) - Winners Quarters - SC64	Video:KOctqz3uvIc	Channel:UC_dkX2_MJZeiYZImFN8AOvg
Cashmere (C. Falcon) vs. RoguePenguin (Mario & Gunner) - Winners Quarters - SC64	Video:2nM-PecJkDo	Channel:UC_dkX2_MJZeiYZImFN8AOvg
Depth (Samus) vs. DewDaDash (Cloud) - Winners R3 - SC64	Video:iLIlhL-VlF8	Channel:UC_dkX2_MJZeiYZImFN8AOvg
Cashmere (C. Falcon) vs. MVG|Yura (Corrin) - Winners R3 - SC64	Video:PulNtFsuCj0	Channel:UC_dkX2_MJZeiYZImFN8AOvg
Duffo (Little Mac) vs. Shoq|Rideae (Pikachu) - Winners R3 - SC64	Video:uiNOEHAyAPw	Channel:UC_dkX2_MJZeiYZImFN8AOvg
WonderBread (Little Mac) vs. PK Kid (Ness) - Winners R3 - SC64	Video:08K2aofkcLM	Channel:UC_dkX2_MJZeiYZImFN8AOvg
Rideae & Cashmere vs. SnarkieFox & RoguePenguin - Doubles Grand Finals - SC64	Video:0phW_70Aye0	Channel:UC_dkX2_MJZeiYZImFN8AOvg
7S|Saj & CrazieCuban vs. SnarkieFox & RoguePenguin - Doubles Losers Finals - SC64	Video:J730vM6W87c	Channel:UC_dkX2_MJZeiYZImFN8AOvg
MVG|Yura & MVG|Ryo vs. SnarkieFox & RoguePenguin - Doubles Losers Semis - SC64	Video:Hbi6DC20Zm8	Channel:UC_dkX2_MJZeiYZImFN8AOvg
CrazieCuban & 7S|Saj vs. Cashmere & Rideae - Doubles Winners Finals - SC64	Video:gkN2bGJz9Xg	Channel:UC_dkX2_MJZeiYZImFN8AOvg
Dabuz (Rosalina & Duck Hunt) vs. Ryo (Roy, Corrin, & Ike) - PRE CEO Friendly Matches	Video:tECKICSt6GM	Channel:UC_dkX2_MJZeiYZImFN8AOvg
Dabuz (Rosalina & Olimar) vs. Mew2King (Cloud) - PRE CEO Friendly Matches	Video:JR0geKku9D8	Channel:UC_dkX2_MJZeiYZImFN8AOvg
Ryo (Rosalina) vs. Dabuz (Roy) - Pre CEO Exhibition Matches	Video:79X-_4sq1_8	Channel:UC_dkX2_MJZeiYZImFN8AOvg
MVG|Ryo (Roy) vs. Kamicario (Lucario) - Exhibition Match - SC63	Video:uE-VfOJnA1A	Channel:UC_dkX2_MJZeiYZImFN8AOvg
RoguePenguin (Mario) vs. Kamicario (Lucario) - Exhibition Match - SC63	Video:bCqO2JjTeS0	Channel:UC_dkX2_MJZeiYZImFN8AOvg
Money Match - Noble|Sol (Little Mac) vs. Kamicario (Lucario & Cloud) - SC63	Video:8O07ARDdgiI	Channel:UC_dkX2_MJZeiYZImFN8AOvg
MVG|Ryo (Ike & Roy) vs. Kamicario (Lucario) - Grand Finals - SC63	Video:7XO-rR8Z4gE	Channel:UC_dkX2_MJZeiYZImFN8AOvg
Noble|Sol (Little Mac) vs. Kamicario (Lucario) - Losers Finals - SC63	Video:r8ViCXafKAs	Channel:UC_dkX2_MJZeiYZImFN8AOvg
Noble|Sol (Little Mac) vs. DewDaDash (Diddy) - Losers Semis - SC63	Video:beOXyvi-VXg	Channel:UC_dkX2_MJZeiYZImFN8AOvg
Noble|Sol (Little Mac) vs. Saj (Peach & Zero Suit) - Losers Quarters - SC63	Video:QKbl5PnvLH4	Channel:UC_dkX2_MJZeiYZImFN8AOvg
MVG|Ryo (Roy & Ike) vs. Kamicario (Lucario) - Winners Finals - SC63	Video:_ZhQDcxOi_g	Channel:UC_dkX2_MJZeiYZImFN8AOvg
Shoq|Rideae (Fox & Pikachu) vs.DewDaDash (Diddy) - Losers R7 - SC63	Video:7167Sx4Ccbc	Channel:UC_dkX2_MJZeiYZImFN8AOvg
Saj (Peach & Zero Suit) vs. Kamicario (Lucario) - Winners Semis - SC63	Video:dgccBCFCMqM	Channel:UC_dkX2_MJZeiYZImFN8AOvg
MVG|Ryo (C. Falcon & Ike) vs. Shoq|Rideae (Pikachu) - Winners Semis - SC63	Video:F2uSC39M0IY	Channel:UC_dkX2_MJZeiYZImFN8AOvg
RoguePenguin (Mario) vs. Kamicario (Lucario) - Winners R4 - SC63	Video:VTHyeXtfsLA	Channel:UC_dkX2_MJZeiYZImFN8AOvg
DewDaDash (Diddy) vs. Saj (Peach) - Winners R4 - SC63	Video:Yq-tYCt5HE4	Channel:UC_dkX2_MJZeiYZImFN8AOvg
DewDaDash (Diddy) vs. Jabe (Olimar) - Winners R3 - SC63	Video:b9ljnvxQC50	Channel:UC_dkX2_MJZeiYZImFN8AOvg
Hala (Ike) vs. Kamicario (Lucario) - Winners R3 - SC63	Video:7dGguI9Ve0M	Channel:UC_dkX2_MJZeiYZImFN8AOvg
MVG|Ryo & MVG|CherubiKnighT vs. RoguePenguin & GX2 - Teams Grand Finals - SC63	Video:E_wetA4PO-I	Channel:UC_dkX2_MJZeiYZImFN8AOvg
MVG|Ryo & MVG|CherubiKnighT vs. Shoq|Rideae & Noble|Sol - Teams Losers Finals - SC63	Video:dOzzhzGph0A	Channel:UC_dkX2_MJZeiYZImFN8AOvg
MVG|Ryo & MVG|CherubiKnighT vs. 7 & BlueBeast - Teams Losers Semis - SC63	Video:WOUmKYO0ttA	Channel:UC_dkX2_MJZeiYZImFN8AOvg
Hala & Hi-Hatz vs. 7 & BlueBeast - Teams Losers Quarters - SC63	Video:LxGC7qAl-js	Channel:UC_dkX2_MJZeiYZImFN8AOvg
$100 Item Money Match - Mew2King vs. Ryo - First to 5	Video:8q2eyUFd0fs	Channel:UC_dkX2_MJZeiYZImFN8AOvg
The Comeback - Mew2King vs. Day	Video:ZzLjG3yNOpw	Channel:UC_dkX2_MJZeiYZImFN8AOvg
MVG|Ryo vs. RoguePenguin (Mario) - Grand Finals - SC62	Video:1dmQWnmGlnM	Channel:UC_dkX2_MJZeiYZImFN8AOvg
Saj (Bayonetta) vs. RoguePenguin (Mario) - Losers Finals - SC62	Video:3w2kTu-34SQ	Channel:UC_dkX2_MJZeiYZImFN8AOvg
Saj (Bayonetta) vs. MVG|Ryo (Corrin, Link, Falcon) - Winners Finals - SC62	Video:RRHD8JA28Og	Channel:UC_dkX2_MJZeiYZImFN8AOvg
CrazieCuban (Diddy) vs. RoguePenguin (Mario) - Losers Semis - SC62	Video:KnR3CyGuSmw	Channel:UC_dkX2_MJZeiYZImFN8AOvg
Noble|Sol (Little Mac) vs. RoguePenguin (Mario) - Losers Quarters - SC62	Video:RuJvZIeqBRg	Channel:UC_dkX2_MJZeiYZImFN8AOvg
CrazieCuban (Diddy) vs.Xmas (Shulk) - Losers Quarters - SC62	Video:ZdofNUgXQSs	Channel:UC_dkX2_MJZeiYZImFN8AOvg
Saj (Bayonetta) vs. RoguePenguin (Mario) - Winners Semis - SC62	Video:UG-kHdeLgRM	Channel:UC_dkX2_MJZeiYZImFN8AOvg
CrazieCuban (Diddy) vs. MVG|Ryo (Doctor Mario & Roy) - Winners Semis - SC62	Video:pzyMyzf8YXk	Channel:UC_dkX2_MJZeiYZImFN8AOvg
Crabby (Dark Pit & Cloud) vs. RoguePenguin (Mario) - Winners R4 - SC62	Video:oT2jUOA1qBo	Channel:UC_dkX2_MJZeiYZImFN8AOvg
CrazieCuban (Diddy) vs. Noble|Sol (Little Mac) - Winners R4 - SC62	Video:ngo9e_ReyoU	Channel:UC_dkX2_MJZeiYZImFN8AOvg
BTVolta (Donkey Kong) vs. MVG|CherubiKnighT (Lucina) - Winners R2 - SC62	Video:2O2K7MNHb6Y	Channel:UC_dkX2_MJZeiYZImFN8AOvg
Zeta (Zero Suit) vs. MN WonderBread (Little Mac) - Winners R3 - SC62	Video:ODZXc9Jb6fA	Channel:UC_dkX2_MJZeiYZImFN8AOvg
MVG|Ryo & MVG|CherubiKinghT vs. Noble|Sol & RoguePenguin - Teams Grand Finals - SC62	Video:kbpg3lrxCqY	Channel:UC_dkX2_MJZeiYZImFN8AOvg
MVG|Ryo & MVG|CherubiKnighT vs. Xmas & Zeta - Teams Losers Finals - SC62	Video:6GkInD1iYU0	Channel:UC_dkX2_MJZeiYZImFN8AOvg
RoguePenguin & Noble|Sol vs. Xmas & Zeta - Teams Winners Finals - SC62	Video:BaRGoU4a8kI	Channel:UC_dkX2_MJZeiYZImFN8AOvg
MVG|Ryo & MVG|CherubiKnighT vs. WonderBread & Smitheyyy - Teams Losers Quarters - SC62	Video:tZ4UGDRch88	Channel:UC_dkX2_MJZeiYZImFN8AOvg
5 Player Free for All!	Video:lvT06XnYP9E	Channel:UC_dkX2_MJZeiYZImFN8AOvg
Item Money Match - Mew2King vs. Ryo	Video:p-pWoYgXFUQ	Channel:UC_dkX2_MJZeiYZImFN8AOvg
Mew2King 4 Stock on Wii U - Mew2King vs. 7	Video:uNMfIkF72R8	Channel:UC_dkX2_MJZeiYZImFN8AOvg
MVG|Ryo (Corrin & Ike) vs. Fox MVG| Mew2King (Cloud) - Grand Finals - SC61	Video:41W2TLRCAQg	Channel:UC_dkX2_MJZeiYZImFN8AOvg
MVG|Ryo (Corrin & Ike) vs. RoguePenguin (Mario) - Losers Finals - SC61	Video:BWLcyaLUOIg	Channel:UC_dkX2_MJZeiYZImFN8AOvg
RoguePenguin (Mario) vs. VGR|DMG Ross (Toon Link & Shulk) - Losers Semis - SC61	Video:JZE2KYz-iHI	Channel:UC_dkX2_MJZeiYZImFN8AOvg
MVG|Ryo (Ganon & Dr. Mario) vs. Fox MVG|Mew2King (Charizard & Donkey Kong) - Winners Finals - SC61	Video:qy9Ij4Jw0ck	Channel:UC_dkX2_MJZeiYZImFN8AOvg
VGR DMG|Ross (Toon Link) vs. Shiny (Ryu) - Losers Quarters - SC61	Video:S0MiM0ZDCc0	Channel:UC_dkX2_MJZeiYZImFN8AOvg
A2 Tachyon (Pikachu) vs. Fox MVG|Mew2King (Cloud) - Winners Semis - SC61	Video:FpcT3LNq_m8	Channel:UC_dkX2_MJZeiYZImFN8AOvg
MVG|Ryo (Ike & Corrin) vs. VGR|DMG|Ross (Toon Link & Cloud) - Winners Semis - SC61	Video:8Mng6gBPQTM	Channel:UC_dkX2_MJZeiYZImFN8AOvg
Fox MVG|Mew2King (Cloud) vs. CrazieCuban (Jigglypuff & Diddy) - Winners R4 - SC61	Video:p5boEyAY13U	Channel:UC_dkX2_MJZeiYZImFN8AOvg
A2 XMAS (Shulk) vs. A2 Tachyon (Pikachu) - Winners R4 - SC61	Video:-AI_D6-8PCA	Channel:UC_dkX2_MJZeiYZImFN8AOvg
MVG|Ryo (Ike) vs. RoguePenguin (Mario) - Winners R4 - SC61	Video:0dylGNKIoBk	Channel:UC_dkX2_MJZeiYZImFN8AOvg
7 (Link) vs. VGR|DMG|Ross (Cloud) - Winners R4 - SC61	Video:Da_TPegg2eI	Channel:UC_dkX2_MJZeiYZImFN8AOvg
MVG|Ryo (Ike & Corrin) vs. zeta (Zero Suit) - Winners R3 - SC61	Video:ZBHdM2zmNmQ	Channel:UC_dkX2_MJZeiYZImFN8AOvg
Tachyon (Pikachu) vs. WonderBread (Little Mac) - Winners R3 - SC61	Video:lfT2KQ9L63s	Channel:UC_dkX2_MJZeiYZImFN8AOvg
Rogue Penguin (Mario) vs.  Gwabs (Yoshi) - Winners R3 - SC61	Video:AZZnsFe30fc	Channel:UC_dkX2_MJZeiYZImFN8AOvg
Tachyon & DMG|Ross vs. Hi-Hatz & Hala - Teams Grand Finals - SC61	Video:zCU2_0gOtFY	Channel:UC_dkX2_MJZeiYZImFN8AOvg
Tachyon & DMG|Ross vs. Fox|MVG|Mew2King & MVG|Ryo - Teams Winners Finals - SC61	Video:J6SLduHlrhg	Channel:UC_dkX2_MJZeiYZImFN8AOvg
Hala & Hi-Hatz vs. Snarkie & RoguePenguin - Teams Losers Semis - SC61	Video:Nls1qUsKhNk	Channel:UC_dkX2_MJZeiYZImFN8AOvg
Mew2King Kawaii Combo	Video:v_gFP6Cat7s	Channel:UC_dkX2_MJZeiYZImFN8AOvg
The 1% - Mew2King vs. Wonderbread	Video:l6jWIE4Q0Q8	Channel:UC_dkX2_MJZeiYZImFN8AOvg
MVG|Ryo (Corrin & Ike) vs. RoguePenguin (Mario) - Grand Finals - SC60	Video:jQZ4_rPCOYY	Channel:UC_dkX2_MJZeiYZImFN8AOvg
MVG|Ryo (Corrin) vs. GoTE|Rideae (Pikachu & Sheik) - Losers Finals - SC60	Video:6fHaCMPNwok	Channel:UC_dkX2_MJZeiYZImFN8AOvg
BlitzKing (Little Mac) vs. GoTE|Rideae (Pikachu) - Losers Semis - SC60	Video:RPvO7JZbjQg	Channel:UC_dkX2_MJZeiYZImFN8AOvg
RoguePenguin (Mario) vs. MVG|Ryo (Bowser, Ganon, & Roy) - Winners Finals - SC60	Video:dnNnfDrDaf8	Channel:UC_dkX2_MJZeiYZImFN8AOvg
Blitzking (Little Mac) vs. Hi-Hatz (Ganondorf) - Losers Quarters - SC60	Video:80ITos7-3JM	Channel:UC_dkX2_MJZeiYZImFN8AOvg
GoTE|Rideae (Pikachu vs. Crabby (Dark Pit) - Losers Quarters - SC60	Video:wP-5xT_W1fU	Channel:UC_dkX2_MJZeiYZImFN8AOvg
RoguePenguin (Mario) vs. GoTE|Rideae (Pikachu & Sheik) - Winners Semis - SC60	Video:_qHZ8bVUB9I	Channel:UC_dkX2_MJZeiYZImFN8AOvg
YEEE (Rosalina) vs. Hi-Hatz (Ganondorf) - Winners R4 - SC60	Video:1G99pf67zEQ	Channel:UC_dkX2_MJZeiYZImFN8AOvg
MVG|Ryo (Ike & Roy) vs. Hala (Ike & Marth) - Winners R4 - SC60	Video:z9P5tSJTNCY	Channel:UC_dkX2_MJZeiYZImFN8AOvg
RoguePenguin (Mario) vs. 7 (Link & Meta Knight) - Winners R4 - SC60	Video:HCj7SBMVee0	Channel:UC_dkX2_MJZeiYZImFN8AOvg
GoTE|Rideae (Pikachu) vs. WonderBread (Little Mac) - Winners R4 - SC60	Video:Xz9cvnjhWIA	Channel:UC_dkX2_MJZeiYZImFN8AOvg
MVG|CherubiKnighT (Lucina) vs. YEEE (Rosalina) - Winners R3 - SC60	Video:uBjqZaERBYQ	Channel:UC_dkX2_MJZeiYZImFN8AOvg
Los Angelos (Pit & Dark Pit) vs. RoguePenguin (Mario) - Winners R2 - SC60	Video:VHJ-DQfbHxk	Channel:UC_dkX2_MJZeiYZImFN8AOvg
Smitheyyy & WonderBread vs. MVG|Ryo & MVG|CherubiKnighT - Doubles Grand Finals - SC60	Video:33bY2n0I9xI	Channel:UC_dkX2_MJZeiYZImFN8AOvg
Smitheyyy & WonderBread vs. Hala & Hi-Hatz - Doubles Losers Finals - SC60	Video:LioPmWRpN8o	Channel:UC_dkX2_MJZeiYZImFN8AOvg
MVG|CherubiKnighT & MVG|Ryo vs. Hi-Hatz & Hala - Doubles Winners Finals - SC60	Video:hNdbLjbTjfc	Channel:UC_dkX2_MJZeiYZImFN8AOvg
All Might (Sonic) vs. TGL|DJ Jack (Ryu) - Grand Finals - CEO Prologue	Video:tMnNZKxVcLs	Channel:UC_dkX2_MJZeiYZImFN8AOvg
PG|MVD (Diddy & Duck Hunt) vs. TGL|DJ Jack (Ryu & Mario) - Losers Finals - CEO Prologue	Video:OKHWXwRNBNU	Channel:UC_dkX2_MJZeiYZImFN8AOvg
PG|MVD (Diddy) vs. Dath (Robin) - Losers Semis - CEO Prologue	Video:BxBnxAKd018	Channel:UC_dkX2_MJZeiYZImFN8AOvg
Dath (Robin) vs. Cashmere (C. Falcon) - Losers Quarters - CEO Prologue	Video:VnhbRIGGkMg	Channel:UC_dkX2_MJZeiYZImFN8AOvg
All Might (Sonic) vs. TGL|DJ Jack (Ryu) - Winners Finals - CEO Prologue	Video:iFt37b7THeE	Channel:UC_dkX2_MJZeiYZImFN8AOvg
MVG|Ryo (Roy & Ike) vs. Cashmere (C. Falcon) - Losers Top 8 - CEO Prologue	Video:Qrt0dAeb9g4	Channel:UC_dkX2_MJZeiYZImFN8AOvg
TGL|DJ Jack (Ryu) vs. Dath (Robin) - Winners Semis - CEO Prologue	Video:AnNNGgLRKKc	Channel:UC_dkX2_MJZeiYZImFN8AOvg
All Might (Sonic) vs. PG|MVD (Diddy & Cloud) - Winners Semis - CEO Prologue	Video:SzlO5IiVX_k	Channel:UC_dkX2_MJZeiYZImFN8AOvg
Saj (Bayonetta) vs. Dath (Robin) - Winners Quarters - CEO Prologue	Video:E44WC0xJQzM	Channel:UC_dkX2_MJZeiYZImFN8AOvg
All Might (Sonic) vs. Riot (Donkey Kong) - Winners Quarters - CEO Prologue	Video:ZeLaSaSHtes	Channel:UC_dkX2_MJZeiYZImFN8AOvg
TGL|DJ Jack (Ryu) vs. Oni Day (Lucario) - Winners Quarters - CEO Prologue	Video:hw9NvutyYr4	Channel:UC_dkX2_MJZeiYZImFN8AOvg
PG|MVD (Diddy) vs. Prince Ramen (Palutena) - Winners Quarters - CEO Prologue	Video:1jT5ROkZeCI	Channel:UC_dkX2_MJZeiYZImFN8AOvg
Saj (Bayonetta) vs. Seibrik (Meta Knight) - Top 32 Winners - CEO Prologue	Video:tUJ7ByPAh3I	Channel:UC_dkX2_MJZeiYZImFN8AOvg
ATR|Xaltis (Rosalina) vs. Oni Day (Lucario) - Top 32 Winners - CEO Prologue	Video:ekx7z2-VZVo	Channel:UC_dkX2_MJZeiYZImFN8AOvg
BlueBeast (Pit) vs. Prince Ramen (Palutena) - Top 32 Winners - CEO Prologue	Video:Y_6Yf2N6z1I	Channel:UC_dkX2_MJZeiYZImFN8AOvg
TGL|DJ Jack (Ryu) vs. Eden (Fox) - Top 32 Winners - CEO Prologue	Video:_0jcAK2GvRU	Channel:UC_dkX2_MJZeiYZImFN8AOvg
Tony (Donkey Kong) vs. Dath (Robin) - Pools Play - CEO Prologue	Video:6mypEaJ9oN8	Channel:UC_dkX2_MJZeiYZImFN8AOvg
DMG Ross (Toon Link) vs. Poltergust (Yoshi) - Pools Play - CEO Prologue	Video:_5wI4_tf9iQ	Channel:UC_dkX2_MJZeiYZImFN8AOvg
ATR|Xaltis (Rosalina ) vs. Cashmere (C. Falcon) - Pools Play - CEO Prologue	Video:24yEH01pBN0	Channel:UC_dkX2_MJZeiYZImFN8AOvg
VS|Master Raven (Sheik) vs. MVG|Dyr (Diddy) - Pools Play - CEO Prologue	Video:GcOUg-cgHNY	Channel:UC_dkX2_MJZeiYZImFN8AOvg
MVG|Ryo (Ike) vs. GoTE|Rideae (Sheik) - Pools Play - CEO Prologue	Video:LO-nfOGGleI	Channel:UC_dkX2_MJZeiYZImFN8AOvg
7 (Meta Knight & Link) vs. Tony (Donkey Kong) - Pools Play - CEO Prologue	Video:mSqrDkwO-xs	Channel:UC_dkX2_MJZeiYZImFN8AOvg
GoTE|Rideae (Pikachu) vs. Dath (Robin) - Pools Play - CEO Prologue	Video:QlXwhTX3Zsc	Channel:UC_dkX2_MJZeiYZImFN8AOvg
PG|MVD (Diddy) vs.  SSHQ|GDX (Diddy) - Pools Play - CEO Prologue	Video:XiTMnMlX1VM	Channel:UC_dkX2_MJZeiYZImFN8AOvg
Noble|Sol (Little Mac) vs, BlueBeast (Pit) - Pools Play - CEO Prologue	Video:uq2608OMzm4	Channel:UC_dkX2_MJZeiYZImFN8AOvg
0
1
2
3
4
5
6
7
8
9
10
11
12
13
14
15
Mew2King (Cloud) vs RoguePenguin (Mario) - Exhibition	Video:FVaby2PRloU	Channel:UC_dkX2_MJZeiYZImFN8AOvg
Ryo (Lucina) vs. Mew2King (Cloud) - Exhibition	Video:HZSxMC2ggow	Channel:UC_dkX2_MJZeiYZImFN8AOvg
Mew2King exploits the Diddy Kong Match Up!	Video:KIQRfxhlDYU	Channel:UC_dkX2_MJZeiYZImFN8AOvg
MVG|Ryo (Little Mac, Roy, Corrin) vs. GoTE|Rideae (Pikachu & Sheik) - Grand Finals - SC59	Video:Ekoj-IaXUYE	Channel:UC_dkX2_MJZeiYZImFN8AOvg
Tachyon (Pikachu) vs. GoTE|Rideae (Pikachu) - Losers Finals - SC59	Video:r6RNWP3iYq8	Channel:UC_dkX2_MJZeiYZImFN8AOvg
Noble|Sol (Little Mac) vs. GoTE|Rideae (Pikachu) - Losers Semis - SC59	Video:Rqi1LxFvT7s	Channel:UC_dkX2_MJZeiYZImFN8AOvg
Plaid (Rosalina) vs. GoTE|Rideae (Pikachu) - Losers Quarters - SC59	Video:9bx0EhjTG08	Channel:UC_dkX2_MJZeiYZImFN8AOvg
Noble|Sol (Little Mac) vs. CrazieCuban (Toon Link) - Losers Quarters - SC59	Video:kF5W5pttbiI	Channel:UC_dkX2_MJZeiYZImFN8AOvg
Tachyon (Pikachu) vs. MVG|Ryo (Roy) - Winners Finals - SC59	Video:OykEFF-091k	Channel:UC_dkX2_MJZeiYZImFN8AOvg
Tachyon (Pikachu) vs. GoTE|Rideae (Pikachu) - Winners Semis - SC59	Video:MNgJOPAO_rg	Channel:UC_dkX2_MJZeiYZImFN8AOvg
MVG|Ryo (Roy) vs. CrazieCuban (Toon Link) - Winners Semis - SC59	Video:SmU6cLyaT5Y	Channel:UC_dkX2_MJZeiYZImFN8AOvg
GoTE|Rideae (Pikachu) vs. Noble|Sol (Little Mac) - Winners Quarters - SC59	Video:T1WEa6aTzfs	Channel:UC_dkX2_MJZeiYZImFN8AOvg
BlueBeast (Pit) vs. Tachyon (Pikachu) - Winners Quarters - SC59	Video:btFKh6h75H4	Channel:UC_dkX2_MJZeiYZImFN8AOvg
Quiksilver (Luigi) vs. CrazieCuban (Toon Link) - Winners Quarters - SC59	Video:tuTqTgpEwnE	Channel:UC_dkX2_MJZeiYZImFN8AOvg
MVG|Ryo (Roy) vs. YEEE (Rosalina) - Winners Quarters - SC59	Video:7q78z_UzB0w	Channel:UC_dkX2_MJZeiYZImFN8AOvg
Volc (Yoshi) vs. Rideae (Pikachu) - Winners R4 - SC59	Video:8T2EqC7dz0s	Channel:UC_dkX2_MJZeiYZImFN8AOvg
BlueBeast (Pit) vs. Rupour (Ness) - Winners R4 - SC59	Video:qbqyLdKvO-g	Channel:UC_dkX2_MJZeiYZImFN8AOvg
Quiksilver (Luigi) vs. Afmbot (Donkey Kong) - Winners R4 - SC59	Video:HIqTnwJM6hw	Channel:UC_dkX2_MJZeiYZImFN8AOvg
YEEE (Rosalina) vs. O Rocket (Diddy) - Winners R4 - SC59	Video:qRXsQdJooD4	Channel:UC_dkX2_MJZeiYZImFN8AOvg
Hi-Hatz (Ganondorf) vs. Tachyon (Pikachu & Duck Hunt) - Winners R4 - SC59	Video:3l4wbsQCI5Y	Channel:UC_dkX2_MJZeiYZImFN8AOvg
Volc (Yoshi) vs. Crabby (Dark Pit) - Winners R3 - SC59	Video:M3DXztUKRyU	Channel:UC_dkX2_MJZeiYZImFN8AOvg
Quicksilver (Luigi) vs. Arctic Fox (Fox) - Winners R3 - SC59	Video:XXlVjgC5Di0	Channel:UC_dkX2_MJZeiYZImFN8AOvg
GX2 (Ryu) vs. 7 (Link) - Winners R3 - SC59	Video:g2Ha8bfodCw	Channel:UC_dkX2_MJZeiYZImFN8AOvg
OC Ebag (Diddy & Luigi) vs. GoTE|Rideae (Pikachu) - Winners R3 - SC59	Video:CjQ0TD19Kfc	Channel:UC_dkX2_MJZeiYZImFN8AOvg
MVG|Ryo (Roy) vs. Saber (Link) - Winners R3 - SC59	Video:SJGAvsGJlu8	Channel:UC_dkX2_MJZeiYZImFN8AOvg
Punctual (Ganondorf) vs. Noble|Sol (Little Mac) - Winners R2 - SC59	Video:zGg71cio0HA	Channel:UC_dkX2_MJZeiYZImFN8AOvg
BT (Wii Fit) vs. Casey Lounge (Donkey Kong) - Winners R2 - SC59	Video:yRqgSBZhgxg	Channel:UC_dkX2_MJZeiYZImFN8AOvg
Bo Fischer (C. Falcon & Lucas) vs. Afmbot (Donkey Kong) - Winners R2 - SC59	Video:UtYDEgGXQn0	Channel:UC_dkX2_MJZeiYZImFN8AOvg
Tachyon & Ross vs. Hi-Hatz & Hala - Doubles Grand Finals - SC59	Video:1oc6TSh4_Hk	Channel:UC_dkX2_MJZeiYZImFN8AOvg
MVG|CherubiKnighT & MVG|Ryo vs. Hi-Hatz & Hala - Doubles Losers Finals - SC59	Video:KASO-5lZE_o	Channel:UC_dkX2_MJZeiYZImFN8AOvg
MVG|Ryo & MVG|CherubiKnighT vs. Ross & Tachyon - Doubles Winners Finals - SC59	Video:kvYt5NRtBHQ	Channel:UC_dkX2_MJZeiYZImFN8AOvg
Heero (Fox & Roy) vs. Oni Day (Lucario) - Grand Finals - EagleLAN	Video:zyWRaSnVMdg	Channel:UC_dkX2_MJZeiYZImFN8AOvg
Oni Heero (Sonic) vs. TGL|DJ Jack (Ryu) - Losers Finals - EagleLAN	Video:cd2kMj65XfY	Channel:UC_dkX2_MJZeiYZImFN8AOvg
Saj (Bayonetta) vs. TGL|DJ Jack (Ryu) - Losers Semis - EagleLAN	Video:ktRst59monI	Channel:UC_dkX2_MJZeiYZImFN8AOvg
Saj (Peach) vs. VS|MasterRaven (Sheik) - Losers Quarters - EagleLAN	Video:wWq0s5lJ7Mg	Channel:UC_dkX2_MJZeiYZImFN8AOvg
Oni Heero (Fox) vs. Oni Day (Lucario) - Winners Finals - EagleLAN	Video:xOQezFsZdTA	Channel:UC_dkX2_MJZeiYZImFN8AOvg
Saj (Bayonetta) vs. Headshot (Samus) - Losers R6 - EagleLAN	Video:uE-vuZuDKN0	Channel:UC_dkX2_MJZeiYZImFN8AOvg
Oni Heero (Sonic) vs. GoTE|8BitMan (ROB) - Winners Semis - EagleLAN	Video:OqLo40W_CzE	Channel:UC_dkX2_MJZeiYZImFN8AOvg
MVG|Ryo (Roy) vs. TGL|DJ Jack (Ryu) - Losers R5 - EagleLAN	Video:rOsB25FHh8A	Channel:UC_dkX2_MJZeiYZImFN8AOvg
Oni Heero (Sonic & Roy) vs. Cayman (Bayonetta) - Losers R5 - EagleLAN	Video:IXMGNPpNtEY	Channel:UC_dkX2_MJZeiYZImFN8AOvg
MVG|Ryo (Corrin) vs. VS|MasterRaven (Sheik) - Winners Quarters - EagleLAN	Video:DqQIfxvz9hY	Channel:UC_dkX2_MJZeiYZImFN8AOvg
PPG|Josh (Diddy) vs. Oni Day (Lucario) - Winners Quarters - EagleLAN	Video:M80GXFSHRaY	Channel:UC_dkX2_MJZeiYZImFN8AOvg
GoTE|8BitMan (ROB) vs. Riot (Bayonetta) - Winners Quarters - EagleLAN	Video:MGFb8RaUJWA	Channel:UC_dkX2_MJZeiYZImFN8AOvg
Cayman (Bayonetta) vs. Son (Lucas) - Winners R1 - EagleLAN	Video:lq8iCeYBlxY	Channel:UC_dkX2_MJZeiYZImFN8AOvg
MVG|Ryo (Ike) vs. ATR|TremendoDude (Shulk) - Winners R1 - EagleLAN	Video:aUGveE35Tgs	Channel:UC_dkX2_MJZeiYZImFN8AOvg
MFM BlackGuyGamer (Wario) vs. Oni Day (Lucario) - Winners R1 - EagleLAN	Video:qWHnweWqwRs	Channel:UC_dkX2_MJZeiYZImFN8AOvg
ATR|Xaltis (Rosalina) vs. Son (Lucas) - Pools - EagleLAN	Video:GIgbpSdoTk4	Channel:UC_dkX2_MJZeiYZImFN8AOvg
MVG|Ryo (Ike) vs. Coffee (Greninja) - Pools - EagleLAN	Video:_LDMYhuT_Fo	Channel:UC_dkX2_MJZeiYZImFN8AOvg
FlirtySouth CB|Chez (Sonic) vs. AkashicSword (Greninja) - Pools - EagleLAN	Video:fl--J8B2aBY	Channel:UC_dkX2_MJZeiYZImFN8AOvg
Saj (Bayonetta) vs. Depth (Samus) - Pools - EagleLAN	Video:RvBW5FgrGQM	Channel:UC_dkX2_MJZeiYZImFN8AOvg
Riot (Bayonetta) vs. Evilgoku (Ganondorf) - Pools - EagleLAN	Video:sUEUR1NKSs8	Channel:UC_dkX2_MJZeiYZImFN8AOvg
Kid G (Mario) vs. MFM BlackGuyGamer (Wario) - Pools 3 - EagleLAN	Video:SYCh3ORLEeE	Channel:UC_dkX2_MJZeiYZImFN8AOvg
BC|Purple Guy (Zelda) vs. Headshot (Samus) - Pools 3 - EagleLAN	Video:xRVEeMEywyA	Channel:UC_dkX2_MJZeiYZImFN8AOvg
MVG|Yura (Corrin) vs. Pringle (Toon Link) - Pools 3 Losers Semis - EagleLAN	Video:SaDL2P-fWJE	Channel:UC_dkX2_MJZeiYZImFN8AOvg
GOTE|Ridae (Pikachu) vs. ATR|TremendoDude (Shulk) - Pools 3 Winners Finals - EagleLAN	Video:yDcbTGSKY-o	Channel:UC_dkX2_MJZeiYZImFN8AOvg
Xaltis & DJ Jack vs. Oni Heero & Oni Day - Grand Finals - EagleLAN	Video:gzfVZw_rmMc	Channel:UC_dkX2_MJZeiYZImFN8AOvg
Tachyon & Ross vs. Oni Heero & Oni Day - Losers Finals - EagleLAN	Video:oI4-q2TBW-o	Channel:UC_dkX2_MJZeiYZImFN8AOvg
Tachyon & Ross vs. Saj & CrazieCuban - Losers Semis - EagleLAN	Video:xdBY4Z96DFI	Channel:UC_dkX2_MJZeiYZImFN8AOvg
DJ Jack & Xaltis vs. Oni Heero & Oni Day - Winners Finals - EagleLAN	Video:t1n6utfhe_k	Channel:UC_dkX2_MJZeiYZImFN8AOvg
DJ Jack & Xaltis vs. Saj & CrazieCuban - Winners Semis - EagleLAN	Video:26qobg6Kz2E	Channel:UC_dkX2_MJZeiYZImFN8AOvg
Snorley & Kino vs. MVG|Ryo & MVG|CherubiKnighT - Losers R5 - EagleLAN	Video:e37DUO6njy4	Channel:UC_dkX2_MJZeiYZImFN8AOvg
Yung Zootie & Gore vs. MasterRaven & MONSTER - Losers R5 - EagleLAN	Video:NaOKgnMCHK8	Channel:UC_dkX2_MJZeiYZImFN8AOvg
Oni Day & Oni Heero vs. XMAS & Degree of Fear - Winners Quarters - EagleLAN	Video:ZVasp0wWFRI	Channel:UC_dkX2_MJZeiYZImFN8AOvg
MVG|CherubiKnighT & MVG|Ryo vs. Ross & Tachyon - Winners Quarters - EagleLAN	Video:16httUfJQ_U	Channel:UC_dkX2_MJZeiYZImFN8AOvg
MVG|Ryo (Ike & Corrin) vs. ScAtt (Mega Man) - Grand Finals - Fusion 3	Video:Zdtq9eo09l8	Channel:UC_dkX2_MJZeiYZImFN8AOvg
ScAtt (Mega Man) vs. COG MVG|Mew2King (Cloud) - Losers Finals - Fusion 3	Video:AIH6EA43Smk	Channel:UC_dkX2_MJZeiYZImFN8AOvg
ScAtt (Mega Man) vs. Fatality (C. Falcon) - Losers Semis - Fusion 3	Video:F0D0Qoas6pI	Channel:UC_dkX2_MJZeiYZImFN8AOvg
Circa|6WX (Sonic) vs. MVG|Ryo (Ike) - Winners Quarters - Fusion 3	Video:JSZmWFHqiGE	Channel:UC_dkX2_MJZeiYZImFN8AOvg
MVG|Ryo (Ike) vs. COG MVG|Mew2King (Cloud) - Winners Finals - Fusion 3	Video:RWKMbwZt11Q	Channel:UC_dkX2_MJZeiYZImFN8AOvg
Mew2King IRL Cloud F-air on Mr. Lz @ Fusion 3	Video:TOGDsx-rZKM	Channel:UC_dkX2_MJZeiYZImFN8AOvg
ScAtt (Mega Man) vs. R3G|Gadiel (Bayonetta) - Losers Quarters - Fusion	Video:8nK0KkJT5Dk	Channel:UC_dkX2_MJZeiYZImFN8AOvg
MVG|Ryo (Ike) vs. ScAtt (Mega Man) - Winners Semis - Fusion	Video:Vzu630NrYVM	Channel:UC_dkX2_MJZeiYZImFN8AOvg
COG MVG|Mew2King (Cloud) vs. Fatality (C. Falcon) - Winners Semis - Fusion	Video:uRxjtpylMRA	Channel:UC_dkX2_MJZeiYZImFN8AOvg
Oni Day (Lucario) vs. ScAtt (Mega Man) - Winners Quarters - Fusion	Video:oKHY5jACZRM	Channel:UC_dkX2_MJZeiYZImFN8AOvg
COG MVG|Mew2King (Cloud) vs. Lord Mix (Bowser) - Winners Quarters - Fusion	Video:g-QMlsni7ko	Channel:UC_dkX2_MJZeiYZImFN8AOvg
Circa|6WX (Sonic) vs. MVG|Ryo (Ike) - Winners Quarters - Fusion	Video:kzkEsO-OIvI	Channel:UC_dkX2_MJZeiYZImFN8AOvg
ScAtt & Neos vs. Fatality & Limbs - Teams Grand Finals - Fusion	Video:5zWXvyYZUS0	Channel:UC_dkX2_MJZeiYZImFN8AOvg
ScAtt & Neos vs. Wrath & Lord Mix - Teams Losers Finals - Fusion	Video:OhIiImjy9Ls	Channel:UC_dkX2_MJZeiYZImFN8AOvg
Neos & ScAtt vs. COG MVG|Mew2King & Oni Day - Teams Losers Semis - Fusion	Video:TqvByi005aw	Channel:UC_dkX2_MJZeiYZImFN8AOvg
6WX & Stingers vs. COG MVG|Mew2King & Oni Day - Teams Losers Quarters - Fusion	Video:ClUSowK5Bnc	Channel:UC_dkX2_MJZeiYZImFN8AOvg
ScAtt & Neos vs. Ice & Gadiel - Teams Losers Quarters - Fusion	Video:2PddKJRaLvs	Channel:UC_dkX2_MJZeiYZImFN8AOvg
MVG|CherubiKnighT & MVG|Ryo vs. Ice & Gadiel - Teams Top 8 Losers - Fusion	Video:iu6bdrYVeaw	Channel:UC_dkX2_MJZeiYZImFN8AOvg
Limbs & Fatality vs. Wrath & Lord Mix - Teams Winners Finals - Fusion	Video:EVnTQRy3NFY	Channel:UC_dkX2_MJZeiYZImFN8AOvg
6WX & Stingers vs. RoguePenguin & Saj - Teams Top 8 Losers - Fusion	Video:_0Nqrkbpj3M	Channel:UC_dkX2_MJZeiYZImFN8AOvg
Limbs & Fatality vs. ScAtt & Neos - Teams Winners Semis - Fusion	Video:BZQfl7cXoRQ	Channel:UC_dkX2_MJZeiYZImFN8AOvg
COG MVG|Mew2King & Oni Day vs. LordMix & Wrath - Teams Winners Semis - Fusion	Video:RIo8Hqt8CwE	Channel:UC_dkX2_MJZeiYZImFN8AOvg
Player 3 & Path vs. MVG|Ryo & MVG|CherubiKnighT - Teams Pools 4 LF - Fusion	Video:qRMfdUskyyc	Channel:UC_dkX2_MJZeiYZImFN8AOvg
MVG|Ryo (Corrin & Ike) vs. Riot (Bayonetta) - Grand Finals - SC58	Video:p9w_uHgNnms	Channel:UC_dkX2_MJZeiYZImFN8AOvg
MVG|Ryo (Ike) vs. COG MVG|Mew2King (Mewtwo) - Losers Finals - SC58	Video:lBYIkXN9cmw	Channel:UC_dkX2_MJZeiYZImFN8AOvg
Oni Day (Lucario) vs. COG MVG|Mew2King (Mewtwo) - Losers Semis - SC58	Video:8helKsjlbPo	Channel:UC_dkX2_MJZeiYZImFN8AOvg
MVG|Ryo (Ike & Corrin) vs. Riot (Bayonetta) - Winners Finals - SC58	Video:AYIi2yHhZOk	Channel:UC_dkX2_MJZeiYZImFN8AOvg
O Fox (Mega Man & Fox) vs. Oni Day (Lucario) - Losers Quarters - SC58	Video:3K9PNfrA_jk	Channel:UC_dkX2_MJZeiYZImFN8AOvg
COG MVG|Mew2King (Mewtwo) vs. RoguePenguin (Mario) - Losers Quarters - SC58	Video:XB1IDePxgtg	Channel:UC_dkX2_MJZeiYZImFN8AOvg
MVG|Ryo (Roy & Ike) vs. Oni Day (Lucario) - Winners Semis - SC58	Video:MdIVV2TCyQM	Channel:UC_dkX2_MJZeiYZImFN8AOvg
Riot (Bayonetta) vs. COG MVG|Mew2King (Mewtwo) - Winners Semis - SC58	Video:G_Ku_JD7M0M	Channel:UC_dkX2_MJZeiYZImFN8AOvg
MVG|Ryo (Corrin & Samus) vs. Rupour (Ness) - Winners R4 - SC58	Video:GE9Pwiha1LU	Channel:UC_dkX2_MJZeiYZImFN8AOvg
Riot (Bayonetta) vs. ROB (C. Falcon) - Winners R4 - SC58	Video:8rI8DcUufFE	Channel:UC_dkX2_MJZeiYZImFN8AOvg
7 (Link) vs. COG MVG|Mew2King (Mewtwo) - Winners R4 - SC58	Video:Q8zLF3uz1Ss	Channel:UC_dkX2_MJZeiYZImFN8AOvg
Oni Day (Lucario) vs. RoguePenguin (Mario) - Winners R4 - SC58	Video:TO-jggxH2vo	Channel:UC_dkX2_MJZeiYZImFN8AOvg
Jabe (Olimar) vs. Rupour (Ness) - Winners R3 - SC58	Video:zNczkuQ0nRI	Channel:UC_dkX2_MJZeiYZImFN8AOvg
MVG|Ryo (Ike) vs. Jaypapo (Roy) - Winners R3 - SC58	Video:-rSmKMWGmXQ	Channel:UC_dkX2_MJZeiYZImFN8AOvg
7 (Link) vs. Tumultus (Samus) - Winners R3 - SC58	Video:igqHiura_gs	Channel:UC_dkX2_MJZeiYZImFN8AOvg
ArcticFox (Fox) vs. COG MVG|Mew2King (Mewtwo) - Winners R3 - SC58	Video:w4W_gUbr_gw	Channel:UC_dkX2_MJZeiYZImFN8AOvg
Riot (Bayonetta) vs. Plaid (Rosalina) - Winners R3 - SC58	Video:xjuKj_5bEAs	Channel:UC_dkX2_MJZeiYZImFN8AOvg
O Fox (Fox) vs. Oni Day (Lucario) - Winners R3 - SC58	Video:ZAqe8ckfoNM	Channel:UC_dkX2_MJZeiYZImFN8AOvg
MVG|CherubiKnighT (Lucina) vs. 7 (Link) - Winners R2 - SC58	Video:s234D9RZ1yU	Channel:UC_dkX2_MJZeiYZImFN8AOvg
Rupour (Ness) vs. Amazo (Cloud) - Winners R2 - SC58	Video:-R6cfMOIXc8	Channel:UC_dkX2_MJZeiYZImFN8AOvg
CrazieCuban (Toon Link) vs. Tumultus (Samus) - Winners R2 - SC58	Video:_Xgnzkszk1E	Channel:UC_dkX2_MJZeiYZImFN8AOvg
MVG|Ryo (Corrin & Samus) vs. Smitheyyy (Sheik) - Winners R2 - SC58	Video:PjWWpNXBsjk	Channel:UC_dkX2_MJZeiYZImFN8AOvg
MVG|CherubiKnighT & MVG|Ryo vs. Oni Day & Rupour - Doubles Grand Finals - SC58	Video:w4UecimE4wc	Channel:UC_dkX2_MJZeiYZImFN8AOvg
MVG|CherubiKnighT & MVG|Ryo vs. RoguePenguin & SnarkyFox - Doubles Losers Finals - SC58	Video:2PCGWLqTY58	Channel:UC_dkX2_MJZeiYZImFN8AOvg
MVG|CherubiKnighT & MVG|Ryo vs. Oni Day & Rupour - Doubles Winners Finals - SC58	Video:ceMr8mJQWPQ	Channel:UC_dkX2_MJZeiYZImFN8AOvg
Mew2King Recites Pi	Video:34IpODI6t5A	Channel:UC_dkX2_MJZeiYZImFN8AOvg
What happens when Mew2King has NO LEDGE?	Video:rJdwIocLQn4	Channel:UC_dkX2_MJZeiYZImFN8AOvg
MVG|Ryo (C. Falcon, Little Mac) vs. COG MVG|Mew2King (C. Falcon, Cloud) - Grand Finals - SC57	Video:AK8qiBebeCU	Channel:UC_dkX2_MJZeiYZImFN8AOvg
MVG|Ryo (Ike) vs. Noble|Sol (Little Mac) - Losers Finals - SC57	Video:WzG6ufeIKVs	Channel:UC_dkX2_MJZeiYZImFN8AOvg
MVG|Ryo (Corrin & Ike) vs. The Great Gonzales (Ness) - Losers Semis - SC57	Video:8DUb--yu_Vk	Channel:UC_dkX2_MJZeiYZImFN8AOvg
Jag (Wario) vs. JaZz (Fox) - Losers R8 - SC57	Video:9Tvse4j5f98	Channel:UC_dkX2_MJZeiYZImFN8AOvg
COG MVG|Mew2King (Cloud) vs. Noble|Sol (Little Mac) - Winners Finals - SC57	Video:82fii5w9m6o	Channel:UC_dkX2_MJZeiYZImFN8AOvg
MVG|Ryo (Corrin) vs. JaZz (Fox) - Losers Quarters - SC57	Video:4du9QS8lvaY	Channel:UC_dkX2_MJZeiYZImFN8AOvg
The Great Gonzales (Ness) vs. O Rocket (Diddy & Donkey Kong) - Losers Quarters - SC57	Video:yghy6bsKA64	Channel:UC_dkX2_MJZeiYZImFN8AOvg
YEEE (Rosalina) vs. O Rocket (Diddy) - Losers R8 - SC57	Video:At4Mo__KpGg	Channel:UC_dkX2_MJZeiYZImFN8AOvg
MVG|Ryo (Samus, Roy,...) vs. Noble|Sol (Little Mac) - Winners Semis - SC57	Video:_WRvuNBOshc	Channel:UC_dkX2_MJZeiYZImFN8AOvg
COG MVG|Mew2King (C. Falcon & Cloud) vs. The Great Gonzales (Ness) - Winners Semis - SC57	Video:ecKWqi6fZSc	Channel:UC_dkX2_MJZeiYZImFN8AOvg
O Rocket (Diddy) vs. MVG|Ryo (Samus & C. Falcon) - Winners Quarters - SC57	Video:mgBKMhhurjE	Channel:UC_dkX2_MJZeiYZImFN8AOvg
YEEE (Rosalina) vs. Noble|Sol (Little Mac) - Winners Quarters - SC57	Video:zLLkBIaFJL8	Channel:UC_dkX2_MJZeiYZImFN8AOvg
JaZz (Fox) vs. COG MVG|Mew2King (Cloud) - Winners Quarters - SC57	Video:_pExCWxP0s0	Channel:UC_dkX2_MJZeiYZImFN8AOvg
The Great Gonzales (Ness) vs. DewDaDash (Diddy) - Winners Quarters - SC57	Video:rzLFqmzjLX4	Channel:UC_dkX2_MJZeiYZImFN8AOvg
MVG|Ryo (Samus) vs. Cadence (Rosalina) - Winners R3 - SC57	Video:V2423zk_F3Y	Channel:UC_dkX2_MJZeiYZImFN8AOvg
JaZz (Fox) vs. MVG|CherubiKnighT (Lucina) - Winners R3 - SC57	Video:-n873Sl_9hw	Channel:UC_dkX2_MJZeiYZImFN8AOvg
Jabe (Olimar) vs. DewDaDash (Diddy) - Winners R4 - SC57	Video:5Ykb4EESjyw	Channel:UC_dkX2_MJZeiYZImFN8AOvg
COG MVG|Mew2King (Cloud & Charizard) vs. Koleslaw (Diddy) - Winners R4 - SC57	Video:H3goBTdSu6c	Channel:UC_dkX2_MJZeiYZImFN8AOvg
GxFire (Mewtwo) vs. Plaid (Rosalina) - Winners R3 - SC57	Video:0sQ_wM0G4aM	Channel:UC_dkX2_MJZeiYZImFN8AOvg
How to 4 Stock Mew2King	Video:RbfqrGst3Oo	Channel:UC_dkX2_MJZeiYZImFN8AOvg
Melee HD is REAL! Kinda (warning this is clickbait lol)	Video:aQ3YdhIONXA	Channel:UC_dkX2_MJZeiYZImFN8AOvg
Mew2King's Opinion on Top/High-tiers + how to abuse Cloud's weakness (read the pastebin)	Video:22WnDCRluCg	Channel:UC_dkX2_MJZeiYZImFN8AOvg
16
17
18
MVG|Ryo & Hala vs. Rupour & Gxfire - Doubles Grand Finals - SC56	Video:Nk1Af7K3YXE	Channel:UC_dkX2_MJZeiYZImFN8AOvg
Noble|Sol (Little Mac) vs. MVG|Ryo (Roy, Falcon, & Ike) - Grand Finals - SC56	Video:tQ7IXATRhl4	Channel:UC_dkX2_MJZeiYZImFN8AOvg
Dewdadash (Diddy) vs. RoguePenguin (Mario) - Losers Semis - SC56	Video:6HUBWlamX_g	Channel:UC_dkX2_MJZeiYZImFN8AOvg
Dewdadash (Diddy) vs. MVG|Ryo (Corrin) - Losers Finals - SC56	Video:51iDrobzCpI	Channel:UC_dkX2_MJZeiYZImFN8AOvg
YEEE (Rosalina) vs. RoguePenguin (Mario) - Losers Quarters - SC56	Video:1_yNHNtYreA	Channel:UC_dkX2_MJZeiYZImFN8AOvg
7 (Link) vs. Dewdadash (Diddy) - Losers Quarters - SC56	Video:8LUseBFSTBk	Channel:UC_dkX2_MJZeiYZImFN8AOvg
MVG|Ryo (Ganon, Dr. Mario, Zelda) vs. Noble|Sol (Little Mac) - Winners Finals - SC56	Video:u7i0aKgYAPs	Channel:UC_dkX2_MJZeiYZImFN8AOvg
YEEE (Rosalina) vs. MVG|Ryo (Link, Lucina, Ike, Jigglypuff) - Winners Semis - SC56	Video:dqOlAtN7J7k	Channel:UC_dkX2_MJZeiYZImFN8AOvg
Dewdadash (Shiek & Diddy) vs. Noble|Sol (Little Mac) - Winners Semis - SC56	Video:cc2sHlKlj1U	Channel:UC_dkX2_MJZeiYZImFN8AOvg
YEEE (Rosalina) vs. Hala (Ike) - Winners R4 - SC56	Video:iEO9zB0J0SE	Channel:UC_dkX2_MJZeiYZImFN8AOvg
TFS SGJet (Shulk) vs. YEEE (Rosalina) - Winners R3 - SC56	Video:o69YmIYGUwU	Channel:UC_dkX2_MJZeiYZImFN8AOvg
Dewdadash (Diddy) vs. RoguePenguin (Mario) - Winners R4 - SC56	Video:Y0vVajGgCOk	Channel:UC_dkX2_MJZeiYZImFN8AOvg
MVG|Ryo (Samus) vs. Crabby (Dark Pit) - Winners R4 - SC56	Video:8e-8ZdeXUTo	Channel:UC_dkX2_MJZeiYZImFN8AOvg
Noble|Sol (Little Mac) vs. Rust (Olimar) - Winners R3 - SC56	Video:qMHMAH1B0xc	Channel:UC_dkX2_MJZeiYZImFN8AOvg
Dewdadash (Diddy) vs. Koleslaw (Diddy) - Winners R3 - SC56	Video:rRDODStNPo8	Channel:UC_dkX2_MJZeiYZImFN8AOvg
Ryo's Pocket Jigglypuff	Video:sGxBToE9PYs	Channel:UC_dkX2_MJZeiYZImFN8AOvg
Rise Above Fate - Who Is MVG|CherubiKnighT?	Video:qvewzkvWZtI	Channel:UC_dkX2_MJZeiYZImFN8AOvg
19
20
21
Noble|Sol (Little Mac) vs. MVG|Ryo (Lucina, Roy, Corrin, Samus) - Grand Finals - SC55	Video:2ttV4ytLs8w	Channel:UC_dkX2_MJZeiYZImFN8AOvg
Noble|Sol (Little Mac) vs. RoguePenguin (Mario) - Losers Finals - SC55	Video:ym5dA_AlF2E	Channel:UC_dkX2_MJZeiYZImFN8AOvg
Hala (Marth & Ike) vs. RoguePenguin (Mario) - Losers Semis - SC55	Video:hqxEphSppWc	Channel:UC_dkX2_MJZeiYZImFN8AOvg
Jabe (Olimar) vs. ROB (C. Falcon) - Losers R8 - SC55	Video:zQXZgd5AztI	Channel:UC_dkX2_MJZeiYZImFN8AOvg
Paradise (Peach & Mewtwo) vs. Hala (Marth) - Losers Quarters - SC55	Video:-jeX40Oknu0	Channel:UC_dkX2_MJZeiYZImFN8AOvg
Paradise (Mewtwo) vs. Hi-Hatz (Ganondorf) - Losers R8 - SC55	Video:69UB4rc4mPE	Channel:UC_dkX2_MJZeiYZImFN8AOvg
MVG|Ryo (C. Falcon) vs. Noble|Sol (Little Mac) - Winners Finals - SC55	Video:Hjolq5Fc1Tc	Channel:UC_dkX2_MJZeiYZImFN8AOvg
Hala (Marth) vs. Noble|Sol (Little Mac) - Winners Semis - SC55	Video:OYqAcSSrqy0	Channel:UC_dkX2_MJZeiYZImFN8AOvg
MVG|Ryo (Falcon, Ganon, Palutena) vs. RoguePenguin (Mario) - Winners Semis - SC55	Video:xVSJTTHLR6A	Channel:UC_dkX2_MJZeiYZImFN8AOvg
O Rocket (Diddy) vs. RoguePenguin (Mario) - Winners Quarters - SC55	Video:nOur-ncw2ag	Channel:UC_dkX2_MJZeiYZImFN8AOvg
Paradise (Mewtwo) vs. Hala (Marth & Ike) - Winners R4 - SC55	Video:y6jp3NHUJEE	Channel:UC_dkX2_MJZeiYZImFN8AOvg
CrazieCuban & Saj vs. Gxfire & Rupour - Doubles Losers Finals - SC55	Video:uqcsHImoq7c	Channel:UC_dkX2_MJZeiYZImFN8AOvg
Tayne (Peach) vs. Noble|Sol (Little Mac) - Winners R4 - SC55	Video:ddq1JnkWX_A	Channel:UC_dkX2_MJZeiYZImFN8AOvg
MVG|Ryo (Ike & Zelda) vs. BowserKingB (Bowser) - Winners R4 - SC55	Video:u-M9YXnEh14	Channel:UC_dkX2_MJZeiYZImFN8AOvg
CrazieCuban & Saj vs. Hi-Hatz & Hala - Doubles Grand Finals - SC55	Video:WaopScypFUw	Channel:UC_dkX2_MJZeiYZImFN8AOvg
CrazieCuban & Saj vs. Noble|Sol & MVG|Ryo - Doubles Losers Semis - SC55	Video:pWaYoo6ZMbA	Channel:UC_dkX2_MJZeiYZImFN8AOvg
Hala & Hi-Hatz vs. Gxfire & Rupour - Doubles Winners Finals - SC55	Video:r4uqBBQJCfI	Channel:UC_dkX2_MJZeiYZImFN8AOvg
Saj (Bayonetta) vs. MVG|Ryo (Link, Corrin, & Ganon) - Grand Finals - SC54	Video:5DcgpFAgYTU	Channel:UC_dkX2_MJZeiYZImFN8AOvg
Saj (Bayonetta) vs. MVG|Sol (Little Mac) - Losers Finals - SC54	Video:brBBlZQOCXs	Channel:UC_dkX2_MJZeiYZImFN8AOvg
RoguePenguin (Mario) vs. Noble|Sol (Little Mac) - Losers Semis - SC54	Video:u54VMqJN1FI	Channel:UC_dkX2_MJZeiYZImFN8AOvg
Hala (Marth) vs. Noble|Sol (Little Mac) - Losers R9 - SC54	Video:Y_xNJlyhi4o	Channel:UC_dkX2_MJZeiYZImFN8AOvg
RoguePenguin (Mario) vs. Hiroi (ZSS) - Losers R9 - SC54	Video:QTb9zc6gMmo	Channel:UC_dkX2_MJZeiYZImFN8AOvg
Saj (Bayonetta) vs. MVG|Ryo (Ike) - Winners Finals - SC54	Video:-R6e7tOsCEU	Channel:UC_dkX2_MJZeiYZImFN8AOvg
Saj (Bayonetta) vs. Noble|Sol (Little Mac) - Winners Semis - SC54	Video:7_xA6cruHX8	Channel:UC_dkX2_MJZeiYZImFN8AOvg
MVG|Ryo (Ike, Roy, & Mac) vs. RoguePenguin (Mario) - Winners Semis - SC54	Video:as18Z5A4lXQ	Channel:UC_dkX2_MJZeiYZImFN8AOvg
Rupour (Ness) vs. 7 (Link) - Losers R7 - SC54	Video:Hn-dL7SZolo	Channel:UC_dkX2_MJZeiYZImFN8AOvg
Jag (Wario) vs. MVG|Ryo (Ike) - Winners Quarters - SC54	Video:1RucIe6xBC0	Channel:UC_dkX2_MJZeiYZImFN8AOvg
Hiroi (ZSS & Peach) vs. Noble|Sol (Little Mac) - Winner Quarters - SC54	Video:9ii-MhLAghQ	Channel:UC_dkX2_MJZeiYZImFN8AOvg
Plaid (Rosalina) vs. Noble|Sol (Little Mac) - Winners R4 - SC54	Video:Lt9oYJr3fgI	Channel:UC_dkX2_MJZeiYZImFN8AOvg
MVG|Ryo & Noble|Sol vs. Hi-Hatz & Hala - Doubles Grand Finals - SC54	Video:rRP27YWOPvc	Channel:UC_dkX2_MJZeiYZImFN8AOvg
Saj & CrazieCuban vs. Hi-Hatz & Hala - Doubles Losers Finals - SC54	Video:r0bncY0J50s	Channel:UC_dkX2_MJZeiYZImFN8AOvg
Saj & CrazieCuban vs. Noble|Sol & MVG|Ryo - Doubles Winners Finals - SC54	Video:JydVNcsCAtY	Channel:UC_dkX2_MJZeiYZImFN8AOvg
LLL|Mr. R Interview - Shots Fired 2	Video:u0Ju1jhV86U	Channel:UC_dkX2_MJZeiYZImFN8AOvg
Liquid|Nairo Interview - Shots Fired 2	Video:sPZj-6ReGrA	Channel:UC_dkX2_MJZeiYZImFN8AOvg
Liquid|Nairo (ZSS) vs. LLL|Mr. R (Sheik) - Grand Finals - Shots Fired 2	Video:SscXNsLYfi4	Channel:UC_dkX2_MJZeiYZImFN8AOvg
#THE Tweek (Cloud) vs. LLL|Mr. R (Sheik) - Losers Finals - Shots Fired 2	Video:RFByAN3-4cU	Channel:UC_dkX2_MJZeiYZImFN8AOvg
LLL|Mr. R (Meta Knight & Sheik) vs. Dabuz (Rosalina) - Losers Semis - Shots Fired 2	Video:KlXhQAVTZC0	Channel:UC_dkX2_MJZeiYZImFN8AOvg
Dabuzzer Beater - Ridiculous POPOFF	Video:2BZo2akPiYQ	Channel:UC_dkX2_MJZeiYZImFN8AOvg
#THE Tweek (Cloud) vs. Liquid|Nairo (ZSS) - Winners Finals - Shots Fired 2	Video:Lo7CM6xbG68	Channel:UC_dkX2_MJZeiYZImFN8AOvg
COG MVG|Mew2King (Cloud) vs. LLL|Mr. R (Sheik) - Top 8 Losers - Shots Fired 2	Video:KL9NLqBZT9I	Channel:UC_dkX2_MJZeiYZImFN8AOvg
SHI-G|9B (Bayonetta) vs. Dabuz (Rosalina) - Top 8 Losers - Shots Fired 2	Video:Yztq-g0-dIY	Channel:UC_dkX2_MJZeiYZImFN8AOvg
COG MVG|Mew2King (Cloud) vs. Liquid|Nairo (ZSS) - Top 8 Winners - Shots Fired 2	Video:8teK0YlswzI	Channel:UC_dkX2_MJZeiYZImFN8AOvg
#THE Tweek (Cloud) vs. Dabuz (Rosalina) - Top 8 Winners - Shots Fired 2	Video:grxp0Bzcbp4	Channel:UC_dkX2_MJZeiYZImFN8AOvg
SHI-G|9B (Bayonetta) vs. K9sbruce (Sheik) - Top 8 Losers - Shots Fired 2	Video:eY2mo_DCdRE	Channel:UC_dkX2_MJZeiYZImFN8AOvg
LLL|Mr. R (Sheik) vs. ANTi (Mario) - Top 8 Losers - Shots Fired 2	Video:hOpOM-EI8n4	Channel:UC_dkX2_MJZeiYZImFN8AOvg
Ranai (Villager) vs. SHI-G|9B (Bayonetta) - Top 32 Losers - Shots Fired 2	Video:KhglA1SOdhc	Channel:UC_dkX2_MJZeiYZImFN8AOvg
CT|Salem (Bayonetta) vs. LLL|Mr. R (Sheik) - Top 32 Losers - Shots Fired 2	Video:b9r6iRDLm0U	Channel:UC_dkX2_MJZeiYZImFN8AOvg
K9sbruce (Sheik) vs. MVG|Ryo (Corrin) - Top 32 Losers - Shots Fired 2	Video:yDd-hy7bzvc	Channel:UC_dkX2_MJZeiYZImFN8AOvg
COG MVG|Mew2King (Cloud) vs. SHI-G|9B (Bayonetta) - Top 32 Winners - Shots Fired 2	Video:al2ZcWc9gXo	Channel:UC_dkX2_MJZeiYZImFN8AOvg
K9sbruce (Sheik) vs. Liquid|Nairo (ZSS) - Top 32 Winners - Shots Fired 2	Video:QCS-gLn6irI	Channel:UC_dkX2_MJZeiYZImFN8AOvg
Dabuz (Rosalina) vs. LLL|Mr. R (Sheik & Meta Knight) - Top 32 Winners - Shots Fired 2	Video:i1N1o_eCpT0	Channel:UC_dkX2_MJZeiYZImFN8AOvg
#THE Tweek (Cloud) vs. ANTi (Mario & Sheik) - Top 32 Winners - Shots Fired 2	Video:zO3pyLkkI_o	Channel:UC_dkX2_MJZeiYZImFN8AOvg
COG MVG|Mew2King (Cloud) vs. Circa|6WX (Sonic) - Top 32 Winners - Shots Fired 2	Video:GOcqrgMfkY4	Channel:UC_dkX2_MJZeiYZImFN8AOvg
SF|Hyuga (Toon Link) vs. K9sbruce (Sheik) - Winners Top 32 - Shots Fired 2	Video:4LaL0V6ZJdU	Channel:UC_dkX2_MJZeiYZImFN8AOvg
Dabuz (Rosalina) vs. MVG|Ryo (Corrin) - Top 32 Winners - Shots Fired 2	Video:SBCddTvzkGk	Channel:UC_dkX2_MJZeiYZImFN8AOvg
Ally (Mario) vs. SHI-G|9B (Bayonetta) - Top 32 Winners - Shots Fired 2	Video:yLde-jI235U	Channel:UC_dkX2_MJZeiYZImFN8AOvg
CT|Salem (Bayonetta) vs. Liquid|Nairo (ZSS) - Top 32 Winners - Shots Fired 2	Video:WDM3UFf9vmY	Channel:UC_dkX2_MJZeiYZImFN8AOvg
PG|MVD (Diddy & Cloud) vs. LLL|Mr. R (Sheik) - Top 32 Winners - Shots Fired 2	Video:BwHs7Sk8e_M	Channel:UC_dkX2_MJZeiYZImFN8AOvg
ANTi (Mario) vs. PG|Esam (Pikachu) - Top 32 Winners - Shots Fired 2	Video:81_N_M8EFy4	Channel:UC_dkX2_MJZeiYZImFN8AOvg
Ally & COG MVG|Mew2King vs. ANTi & LLL|Mr. R - Grand Finals Doubles - Shots Fired 2	Video:qIb8lXnhAF0	Channel:UC_dkX2_MJZeiYZImFN8AOvg
Ally & COG MVG|Mew2King vs. Liquid|Nairo & #THE Tweek - Losers Finals Doubles - Shots Fired 2	Video:WKAM8lkmQVc	Channel:UC_dkX2_MJZeiYZImFN8AOvg
Liquid|Nairo & #THE Tweek vs. PG|MVD & PG|Esam - Losers Semis Doubles - Shots Fired 2	Video:dt8u0Xn4FhA	Channel:UC_dkX2_MJZeiYZImFN8AOvg
ANTi & LLL|Mr. R vs. COG MVG|Mew2King & Ally - Winners Finals Doubles - Shots Fired 2	Video:lTR3d2UgNSc	Channel:UC_dkX2_MJZeiYZImFN8AOvg
Liquid|Nairo & #THE Tweek vs. SS|Mr. E & Dio - Losers Quarters Doubles - Shots Fired 2	Video:k3j-IuR2eZg	Channel:UC_dkX2_MJZeiYZImFN8AOvg
PG|Esam & PG|MVD vs. Ranai & SHI-G|9B - Losers Quarters Doubles - Shots Fired 2	Video:cKdNHt_eQ1A	Channel:UC_dkX2_MJZeiYZImFN8AOvg
Dabuz & Gunblade vs. SS|Mr. E & Dio - Top 8 Losers Doubles - Shots Fired 2	Video:AW9PGTrkR0U	Channel:UC_dkX2_MJZeiYZImFN8AOvg
PG|Esam & PG|MVD vs. BreaD & HoH_Venom - Top 8 Losers Doubles - Shots Fired 2	Video:eKMB5lCMKNM	Channel:UC_dkX2_MJZeiYZImFN8AOvg
ANTi & LLL|Mr. R vs. #THE Tweek & Liquid|Nairo - Winners Semis Doubles - Shots Fired 2	Video:ySFG5BqcJgI	Channel:UC_dkX2_MJZeiYZImFN8AOvg
Ally & COG MVG|Mew2King vs. Ranai & SHI-G|9B - Winners Semis Doubles - Shots Fired 2	Video:zMxghHLbQco	Channel:UC_dkX2_MJZeiYZImFN8AOvg
(.Y.) K9sbruce & Wii Twerk Trainer vs. BreaD & HoH_Venom - Top 16 Doubles - Shots Fired 2	Video:z6Gz_BErmBg	Channel:UC_dkX2_MJZeiYZImFN8AOvg
Sparkle & Dark Wizzy vs. Ranai & SHI-G|9B - Top 16 Doubles - Shots Fired 2	Video:txCo_9DjkPU	Channel:UC_dkX2_MJZeiYZImFN8AOvg
(.Y.) K9sbruce & Wii Twek Trainer & #THE Tweek & Liquid|Nairo - Top 16 Doubles - Shots Fired 2	Video:aA_ePkzA4vQ	Channel:UC_dkX2_MJZeiYZImFN8AOvg
MVG|Ryo & Hi-Hatz vs. Max Ketchum & LoF False - Money Match - Shots Fired 2	Video:Zim7QzP7mms	Channel:UC_dkX2_MJZeiYZImFN8AOvg
CT|Chibo (Gunner & ROB) vs. SS|Mr.E (Marth) - Pools Play - Shots Fired 2	Video:Eo1jYCe8L1M	Channel:UC_dkX2_MJZeiYZImFN8AOvg
Ranai (Villager) vs. HE|Smash GOD (Corrin) - Pools Play - Shots Fired 2	Video:awgwI7B6yEk	Channel:UC_dkX2_MJZeiYZImFN8AOvg
DTN8|HoH_SuperGirlKels (Kirby & Sonic) vs. MVG|Ryo (Ike & Corrin) - Shots Fired 2	Video:c94JkYBU9ro	Channel:UC_dkX2_MJZeiYZImFN8AOvg
PG|MVD (Diddy) vs. DMG|Hooded (Ryu) - Pools Play - Shots Fired 2	Video:XslU_O-OipY	Channel:UC_dkX2_MJZeiYZImFN8AOvg
#THE Tweek (Cloud) vs. Seibrik (Meta Knight) - Pools Play - Shots Fired 2	Video:60W0dIe8ZD4	Channel:UC_dkX2_MJZeiYZImFN8AOvg
Dabuz (Rosalina) vs. SS|Mr.E (Marth) - Pools Play - Shots Fired 2	Video:fj8dvUGOkhM	Channel:UC_dkX2_MJZeiYZImFN8AOvg
CT|Chibo (ROB) vs. DTN8|HoH_SuperGirlKels (Sonic) - Pools Play - Shots Fired 2	Video:s5h7GcwnDy0	Channel:UC_dkX2_MJZeiYZImFN8AOvg
RV Yura (Corrin) vs. DMG|Hooded (Ryu) - Pools Play - Shots Fired 2	Video:0KJbXO68brQ	Channel:UC_dkX2_MJZeiYZImFN8AOvg
Seibrik (Meta Knight) vs. MVG|CherubiKnighT (Lucina) - Pools Play - Shots Fired 2	Video:hgAkrBYv18I	Channel:UC_dkX2_MJZeiYZImFN8AOvg
BreaD (ZSS) vs. Ranai (Villager) - Pools Play - Shots Fired 2	Video:abO2a1tQaE4	Channel:UC_dkX2_MJZeiYZImFN8AOvg
Nexus Ho3k|John Numbers (Wii Fit) vs. Hawk (Fox) - Pools Play - Shots Fired 2	Video:OLiPGH5AxzQ	Channel:UC_dkX2_MJZeiYZImFN8AOvg
MVG|Dyr (Diddy) vs. Nexus Unknown (Sheik) - Pools Play - Shots Fired 2	Video:CjxMcO75eo0	Channel:UC_dkX2_MJZeiYZImFN8AOvg
UG|LingLing (Peach) vs. Nexus FullofDream (Robin) - Pools Play - Shots Fired 2	Video:COnlaGFAF3M	Channel:UC_dkX2_MJZeiYZImFN8AOvg
Royal (Donkey Kong) vs. Dio (Mario) - Pools Play - Shots Fired 2	Video:7fA2ymGzH5o	Channel:UC_dkX2_MJZeiYZImFN8AOvg
Tampa Bison (M. Bison) vs. Liquid|NuckleDu (Nash) - Grand Finals - TNS 6	Video:4eRUQnofBvE	Channel:UC_dkX2_MJZeiYZImFN8AOvg
Flash Metroid (Vega & R. Mika) vs. Tampa Bison (M.Bison) - Losers Finals - TNS 6	Video:Vc8ZAhYW8VA	Channel:UC_dkX2_MJZeiYZImFN8AOvg
Tampa Bison (M. Bison) vs. Liquid|NuckleDu (Nash) - Winners Finals - TNS 6	Video:VpTBMEvacvc	Channel:UC_dkX2_MJZeiYZImFN8AOvg
Flash Metroid (Vega) vs. Peter C (Nash) - Losers Quarters - TNS 6	Video:SgrXsC9xs8Y	Channel:UC_dkX2_MJZeiYZImFN8AOvg
Peter C (Nash) vs. Lord Wilbur (Rashid) - Losers Quarters - TNS 6	Video:GLq9YZzrWzY	Channel:UC_dkX2_MJZeiYZImFN8AOvg
Crespo (Ryu) vs. Clearzoa (R. Mika) - Losers Quarters - TNS 6	Video:TBPx6O_O3jw	Channel:UC_dkX2_MJZeiYZImFN8AOvg
Liquid|NuckleDu (Nash) vs. Crespo (Ryu) - Winners Semis - TNS 6	Video:inNpFqEjHgg	Channel:UC_dkX2_MJZeiYZImFN8AOvg
Clearzova (R.Mika) vs. Kinetic Semiij (Necalli) - Winners Semis - TNS 6	Video:mOZ43-RoDh0	Channel:UC_dkX2_MJZeiYZImFN8AOvg
Tampa Bison (M. Bison) vs. Flash Metroid (Vega) - Winners Semis - TNS 6	Video:fR-XKn4kEpY	Channel:UC_dkX2_MJZeiYZImFN8AOvg
COG MVG|Mew2King (Cloud) vs. Seibrik (Meta Knight, Mega Man, Cloud) - Grand Finals - TNS 6	Video:oChsO0-iP0Q	Channel:UC_dkX2_MJZeiYZImFN8AOvg
COG MVG|Mew2King (Cloud) vs. PG|MVD (Diddy Kong) - Losers Finals - TNS 6	Video:pBJuGjBnlig	Channel:UC_dkX2_MJZeiYZImFN8AOvg
COG MVG|Mew2King (Cloud) vs. ONI|Day (Lucario) - Losers Semis - TNS 6	Video:_2PIS-V2_Gk	Channel:UC_dkX2_MJZeiYZImFN8AOvg
Mew2King (Cloud) vs. CPU (Meta Knight) - Exhibition - TNS 6	Video:eXRUJak6rk8	Channel:UC_dkX2_MJZeiYZImFN8AOvg
PG|MVD (Diddy) vs. Seibrik (Meta Knight) - Winners Finals - TNS 6	Video:9WQjOm86hnI	Channel:UC_dkX2_MJZeiYZImFN8AOvg
Oni Day (Lucario) vs. TGL|DJ Jack (Ryu) - Losers Quarters - TNS 6	Video:FZvy6o9LX-k	Channel:UC_dkX2_MJZeiYZImFN8AOvg
COG MVG|Mew2King (Cloud) vs. VS|NickRiddle (ZSS, Bowser, Marth) - Losers Quarters - TNS 6	Video:6v5PuAawl9A	Channel:UC_dkX2_MJZeiYZImFN8AOvg
COG MVG|Mew2King (Cloud) vs. Prince Ramen (Palutena) - Losers Quarters - TNS 6	Video:WJ-Ka-DYjNE	Channel:UC_dkX2_MJZeiYZImFN8AOvg
PG|MVD (Diddy) vs. VS|NickRiddle (ZSS) - Winners Semis - TNS 6	Video:hP_904B1sew	Channel:UC_dkX2_MJZeiYZImFN8AOvg
Oni Day (Lucario) vs. Seibrik (Meta Knight) - Top 8 - TNS 6	Video:dJUQ7qsqIK0	Channel:UC_dkX2_MJZeiYZImFN8AOvg
ARC|Myran (Olimar) vs. TGL|DJ Jack (Ryu) - Top 8 - TNS 6	Video:uP-dHjq6h4g	Channel:UC_dkX2_MJZeiYZImFN8AOvg
COG MVG|Mew2King (Sheik & Marth) vs. SS|Colbol (Fox) - Grand Finals - TNS 6	Video:HLodT6XSKug	Channel:UC_dkX2_MJZeiYZImFN8AOvg
PG|Plup (Fox, Sheik, Samus) vs. SS|Colbol (Fox & Marth) - Losers Finals - TNS 6	Video:Klqig5YeM_Q	Channel:UC_dkX2_MJZeiYZImFN8AOvg
PG|Plup (Sheik) vs. COG MVG|Mew2King (Sheik) - Melee Winners Finals - TNS 6	Video:tBkGQh9Isb4	Channel:UC_dkX2_MJZeiYZImFN8AOvg
Gahtzu (C. Falcon) vs. SS|Colbol (Fox) - Melee Losers Semis - TNS 6	Video:A7D0L4M1uS4	Channel:UC_dkX2_MJZeiYZImFN8AOvg
Gahtzu (C. Falcon) vs. COG MVG|Mew2King (Sheik) - Top 8 - TNS 6	Video:_KBaw7fjdA4	Channel:UC_dkX2_MJZeiYZImFN8AOvg
PG|Plup (Sheik & Samus) vs. SS|Colbol (Fox) - Melee Top 8 - TNS 6	Video:46wqdIKP8DQ	Channel:UC_dkX2_MJZeiYZImFN8AOvg
VGR DMG|Ross & Tachyon vs. VS|NickRiddle & Seibrik - Doubles Bracket - TNS 6	Video:2iA-rtzuFZM	Channel:UC_dkX2_MJZeiYZImFN8AOvg
Excel_Zero & Master Gheb vs. VS|Nickriddle & Tachyon - Doubles Bracket - TNS 6	Video:uqgnJuO5_CQ	Channel:UC_dkX2_MJZeiYZImFN8AOvg
PG|MVD & Heero vs. Tachyon & VGR DMG|Ross - Doubles Bracket - TNS 6	Video:V1PyrFv4f6c	Channel:UC_dkX2_MJZeiYZImFN8AOvg
COG MVG|Mew2King & MVG|Ryo vs. Cashmere & Rideae - Doubles Bracket - TNS 6	Video:JM5rF6p-5bA	Channel:UC_dkX2_MJZeiYZImFN8AOvg
COG MVG|Mew2King & MVG|Ryo vs. ATR|Xaltis & TGL|DJ Jack - Doubles Bracket - TNS 6	Video:PWA_r_bGpQo	Channel:UC_dkX2_MJZeiYZImFN8AOvg
MamsterP & 3FreshLade vs. Eden & TrueBlue - Doubles Bracket - TNS 6	Video:14YBs6OVsk8	Channel:UC_dkX2_MJZeiYZImFN8AOvg
VGR DMG|Ross & Tachyon vs. MSBCCB|Chez & Oni Day - Doubles Bracket - TNS 6	Video:6W6f3Ok8b7E	Channel:UC_dkX2_MJZeiYZImFN8AOvg
PG|MVD & Heero vs. ARC|Myran & KidG - Doubles Bracket - TNS 6	Video:5rkHeMySweQ	Channel:UC_dkX2_MJZeiYZImFN8AOvg
Excel_Zero & Master Gheb vs. Vindicator & Sportslinger - Double Bracket - TNS 6	Video:36i5ph6rnCc	Channel:UC_dkX2_MJZeiYZImFN8AOvg
Heero (Sonic) vs. COG MVG|Mew2King (Cloud) - Top 32 - TNS 6	Video:MFmtFOsggMI	Channel:UC_dkX2_MJZeiYZImFN8AOvg
Seibrik (Meta Knight) vs. Prince Ramen (Palutena) - Top 32 - TNS 6	Video:GkIsBpO8L8s	Channel:UC_dkX2_MJZeiYZImFN8AOvg
Prince Ramen (Palutena) vs. Noble|Sol (Little Mac) - Top 32 - TNS 6	Video:t9H-1iPRYBc	Channel:UC_dkX2_MJZeiYZImFN8AOvg
Oni Day (Lucario) vs. Heero (Sonic) - Top 32 - TNS 6	Video:oHCLNnWVvV4	Channel:UC_dkX2_MJZeiYZImFN8AOvg
TGL|DJ Jack (Ryu) vs. VS|NickRiddle (ZSS) - Top 32 - TNS 6	Video:DYuu7dd_cCw	Channel:UC_dkX2_MJZeiYZImFN8AOvg
PG|MVD (Diddy) vs. Saj (Bayonetta) - Top 32 - TNS 6	Video:tZK9D6W3nts	Channel:UC_dkX2_MJZeiYZImFN8AOvg
MVG|Ryo (Corrin & Ike) vs. Seibrik (Meta Knight) - Top 32 - TNS 6	Video:iE8KRsUAsWg	Channel:UC_dkX2_MJZeiYZImFN8AOvg
BC GOTE|8BitMan (ROB) vs. Prince Ramen (Palutena) - Top 32 - TNS 6	Video:4qCGZTNJMCU	Channel:UC_dkX2_MJZeiYZImFN8AOvg
Oni Day (Lucario) vs. ARC|Myran (Olimar) - Top 32 - TNS 6	Video:Qo5ABBnN5Bg	Channel:UC_dkX2_MJZeiYZImFN8AOvg
Heero (Sonic) vs. VS|MasterRaven (Sheik) - Top 32 - TNS 6	Video:xVd7Q4fJAws	Channel:UC_dkX2_MJZeiYZImFN8AOvg
TGL|DJ Jack (Ryu) vs. Noble|Sol (Little Mac) - Top 32 - TNS 6	Video:EfmufCb8gMQ	Channel:UC_dkX2_MJZeiYZImFN8AOvg
VS|NickRiddle (ZSS) vs. JaK (Diddy) - Top 32 - TNS 6	Video:hLGH-Ys08to	Channel:UC_dkX2_MJZeiYZImFN8AOvg
Saj (Bayonetta) vs. COG MVG|Mew2King (Cloud) - Top 32 - TNS 6	Video:ve8g56aJoDU	Channel:UC_dkX2_MJZeiYZImFN8AOvg
PG|MVD (Diddy) vs, MVG|Dyr (Diddy) - Top 32 - TNS 6	Video:LHesSAghLbY	Channel:UC_dkX2_MJZeiYZImFN8AOvg
Excel_Zero (Peach) vs. Tempo (Falco) - Melee Top 16 - TNS 6	Video:aBTHyfUad0U	Channel:UC_dkX2_MJZeiYZImFN8AOvg
TGL|Shamunt (Peach) vs. EPSR|Eval (Sheik) - Melee Top 16 - TNS 6	Video:hlbQ3rm2S90	Channel:UC_dkX2_MJZeiYZImFN8AOvg
DrunkSloth (Climbers) vs. Prof (Marth) - Melee Top 8 - TNS 6	Video:RyyujI39cp8	Channel:UC_dkX2_MJZeiYZImFN8AOvg
ESPR|Eval (Peach) vs. SS|Colbol (Fox) - Melee Top 16 - TNS 6	Video:gocVEAiTFPA	Channel:UC_dkX2_MJZeiYZImFN8AOvg
Excel_Zero (Peach) vs. Gahtzu (C. Falcon) - Melee Top 16 - TNS 6	Video:GR3AeQMk8rY	Channel:UC_dkX2_MJZeiYZImFN8AOvg
DrunkSloth (Climbers) vs. COG MVG|Mew2King (Peach & Fox) - Melee Top 8 - TNS 6	Video:4f_o6ssL7cw	Channel:UC_dkX2_MJZeiYZImFN8AOvg
PG|Plup (Sheik) vs. VS|Porkchops (Falco) - Melee Top 16 - TNS 6	Video:GlUUtzwq-Ho	Channel:UC_dkX2_MJZeiYZImFN8AOvg
Cashmere (C. Falcon) vs. Port (Pac-Man) - Pool Play - TNS 6	Video:2NDJTlpqHfM	Channel:UC_dkX2_MJZeiYZImFN8AOvg
Mr. Wolff (Peach) vs. YungKobe (Rosalina) - Pools Play - TNS 6	Video:9dc0o5-ljYg	Channel:UC_dkX2_MJZeiYZImFN8AOvg
Afmbot (Donkey Kong) vs. CrazieCuban (Toon Link & Jigglypuff) - Pools Play - TNS 6	Video:K1VgYQGI35U	Channel:UC_dkX2_MJZeiYZImFN8AOvg
Eden (Fox) vs. CnR Zevf (Meta Knight) - Pools Play - TNS 6	Video:sUFa6RrKGVg	Channel:UC_dkX2_MJZeiYZImFN8AOvg
LewdLuis (Robin) vs. CnR Zevf (Meta Knight) - Pools Play - TNS 6	Video:nZ0MImX5o4s	Channel:UC_dkX2_MJZeiYZImFN8AOvg
Mugi (Corrin) vs. Doom (Rosalina) - Pools Play - TNS 6	Video:QEeL3s7_gWk	Channel:UC_dkX2_MJZeiYZImFN8AOvg
Mugi (Corrin) vs. Jade (Bowser Jr.) - Pools Play - TNS 6	Video:MWM6WhRyij0	Channel:UC_dkX2_MJZeiYZImFN8AOvg
Oni Day (Lucario) vs. P2W Monster (Cloud) - Pools Play - TNS 6	Video:gjrMHMjloog	Channel:UC_dkX2_MJZeiYZImFN8AOvg
Afmbot (Donkey Kong) vs. Heero (Sonic) - Pools Play - TNS 6	Video:c0-A9sUSBkQ	Channel:UC_dkX2_MJZeiYZImFN8AOvg
Eden (Fox) vs. ARC|Myran (Olimar) - Pools Play - TNS 6	Video:kSJHeE8NzrA	Channel:UC_dkX2_MJZeiYZImFN8AOvg
VS|MasterRaven (Sheik) vs. Doom (Rosalina) - Pools Play - TNS 6	Video:smcO4l0Cxb0	Channel:UC_dkX2_MJZeiYZImFN8AOvg
The Gount (Ryu) vs. Kid G (Mario) - Pools Play - TNS 6	Video:7ihBK_3dIBM	Channel:UC_dkX2_MJZeiYZImFN8AOvg
Radda Radda (G&W) vs. Masta Puma (Ryu) - Pools Play - TNS 6	Video:Gd9kGXnB21A	Channel:UC_dkX2_MJZeiYZImFN8AOvg
Radda Radda (G&W) vs. Omni (Sheik) - Pools Play - TNS 6	Video:wWFVM3j2ni8	Channel:UC_dkX2_MJZeiYZImFN8AOvg
Zade (Mario) vs. The Gount (Ryu) - Pools Play - TNS 6	Video:YOxJNq2I_w0	Channel:UC_dkX2_MJZeiYZImFN8AOvg
D2da (Meta Knight) vs. BBG|AdmiralFunk (Bowser Jr.) - Pools Play - TNS 6	Video:edhj5UtnZik	Channel:UC_dkX2_MJZeiYZImFN8AOvg
Noble|Sol (Little Mac) vs. ICG|LordFrieza (Wario) - Pools Play - TNS 6	Video:U6iCr0dOahg	Channel:UC_dkX2_MJZeiYZImFN8AOvg
Noa (Ness) vs. Rideae (Pikachu) - Pools Play - TNS 6	Video:aNM53c0kh6w	Channel:UC_dkX2_MJZeiYZImFN8AOvg
JaK (Diddy) vs. BBG|AdmiralFunk (Bowser Jr.) - Pools Play - TNS 6	Video:39kUdW-8rks	Channel:UC_dkX2_MJZeiYZImFN8AOvg
cE|StreetShark (Sonic) vs. D2da (Meta Knight) - Pools Play - TNS 6	Video:wLZvYGyEi-A	Channel:UC_dkX2_MJZeiYZImFN8AOvg
TGL|DJ Jack (Ryu) vs, Rideae (Pikachu) - Pools Play - TNS 6	Video:hXwAKb_kdwI	Channel:UC_dkX2_MJZeiYZImFN8AOvg
BBG|Admiral Funk (Bowser Jr.) vs. MSBCCB|Chez (Sonic) - Pools Play - TNS 6	Video:wjho8Pk_exM	Channel:UC_dkX2_MJZeiYZImFN8AOvg
BBG|AdmiralFunk (Bowser Jr.) vs. cE|StreetShark (Cloud) - Pools Play - TNS 6	Video:211UNeBD50c	Channel:UC_dkX2_MJZeiYZImFN8AOvg
Elio (Corrin) vs. Excel_Zero (Bayonetta) - Pools Play - TNS 6	Video:ezFttWwQNX8	Channel:UC_dkX2_MJZeiYZImFN8AOvg
JaZz (Fox) vs. VGR DMG|Ross (Toon Link) - Pools Play - TNS 6	Video:p3hSm7rAaCo	Channel:UC_dkX2_MJZeiYZImFN8AOvg
ATR|TremendoDude (Shulk) vs. cE|Ookami (Mega Man) - Pools Play - TNS 6	Video:xz541PqZHqc	Channel:UC_dkX2_MJZeiYZImFN8AOvg
ATR|Xaltis (Bayonetta) vs. 3FreshLade (Meta Knight) - Pools Play - TNS 6	Video:tyUUTIy0nw0	Channel:UC_dkX2_MJZeiYZImFN8AOvg
Mamster-P (Ness) vs. Tito (Diddy) - Pools Play - TNS 6	Video:NTIEqPHfOLg	Channel:UC_dkX2_MJZeiYZImFN8AOvg
Crabby (Dark Pit) vs. Tito (Diddy) - Pools Play - TNS 6	Video:zodWuMHPdE0	Channel:UC_dkX2_MJZeiYZImFN8AOvg
COG MVG|Mew2King (Cloud) vs. Excel_Zero (Bayonetta) - Pools Plays - TNS6	Video:oYere0quzEY	Channel:UC_dkX2_MJZeiYZImFN8AOvg
PG|MVD (Diddy) vs. VGR DMG|Ross (Toon Link) - Pools Play - TNS6	Video:w3rBsbKUGqc	Channel:UC_dkX2_MJZeiYZImFN8AOvg
MVG|Ryo (Link, Roy, Marth, Corrin) vs. Riot (Donkey Kong) - Grand Finals - SC52	Video:ZukqoZJEN88	Channel:UC_dkX2_MJZeiYZImFN8AOvg
7 (Meta Knight) vs. Riot (Donkey Kong) - Losers Finals - SC52	Video:ZQxk1OL0qg0	Channel:UC_dkX2_MJZeiYZImFN8AOvg
Depth (Samus) vs. Riot (Donkey Kong) - Losers Semis - SC52	Video:OfaDLAnZo9U	Channel:UC_dkX2_MJZeiYZImFN8AOvg
Riot (Donkey Kong) vs. Plaid (Rosalina) - Losers R9 - SC52	Video:5YhFGthblZs	Channel:UC_dkX2_MJZeiYZImFN8AOvg
Depth (Samus) vs. cE|Yld (Olimar) - Losers R9 - SC52	Video:bjfaFEtpAd4	Channel:UC_dkX2_MJZeiYZImFN8AOvg
Plaid (Rosalina) vs. Mugi (Corrin & Dark Pit) - Losers R8 - SC52	Video:pVWTyuE5UFI	Channel:UC_dkX2_MJZeiYZImFN8AOvg
MVG|Ryo (Corrin) vs. 7 (Link) - Winners Finals - SC52	Video:l9-DcqSL89w	Channel:UC_dkX2_MJZeiYZImFN8AOvg
MVG|Ryo (Corrin) vs. Depth (Samus) - Winners Semis - SC52	Video:Y-083l6U97U	Channel:UC_dkX2_MJZeiYZImFN8AOvg
Riot (Donkey Kong) vs. 7 (Link & Meta Knight) - Winners Semis - SC52	Video:53socaAQLmg	Channel:UC_dkX2_MJZeiYZImFN8AOvg
Depth (Samus) vs. RoguePenguin (Mario) - Winners Semis - SC52	Video:xgbwcilvkvA	Channel:UC_dkX2_MJZeiYZImFN8AOvg
7 (Link) vs. ROB (C. Falcon) - Winners Quarters - SC52	Video:stGTZ0N5oqE	Channel:UC_dkX2_MJZeiYZImFN8AOvg
Lupo (Cloud) vs. Riot (Donkey Kong) - Winners Quarters - SC52	Video:8cWSTQT3opg	Channel:UC_dkX2_MJZeiYZImFN8AOvg
MVG|Ryo (Roy & C.Falcon) vs. Mugi (Corrin) - Winners Quarters - SC52	Video:779_VEO-e-4	Channel:UC_dkX2_MJZeiYZImFN8AOvg
cE|Yld (Villager) vs. RoguePenguin (Mario) - Winners R4 - SC52	Video:iDEN1ecFAPE	Channel:UC_dkX2_MJZeiYZImFN8AOvg
Crabby (Dark Pit) vs. 7 (Link)  - Winner R3 - SC52	Video:Yio9n-TDx80	Channel:UC_dkX2_MJZeiYZImFN8AOvg
JayPapo (Roy) vs. Jabe (Olimar) - Winners R3 - SC52	Video:4ggDdSbmpwE	Channel:UC_dkX2_MJZeiYZImFN8AOvg
ROB (C. Falcon) vs. Pickler (Yoshi) - Winners R3 - SC52	Video:C-nxyA7ZeTQ	Channel:UC_dkX2_MJZeiYZImFN8AOvg
D6 (Link) vs. Riot (Donkey Kong) - Winners R1 - SC52	Video:7bsCAnXRE6E	Channel:UC_dkX2_MJZeiYZImFN8AOvg
Riot & VGR DMG|Ross vs. cE|Yld & Mugi - Team Grand Finals - SC52	Video:Io3BrdvwEYA	Channel:UC_dkX2_MJZeiYZImFN8AOvg
eSportsDolo & Hi-Hatz vs. cE|Yld & Mugi - Teams Losers Finals - SC52	Video:hB2QZF_HYQE	Channel:UC_dkX2_MJZeiYZImFN8AOvg
Haru & Depth vs. cE|Yld & Mugi - Teams Losers Semis - SC52	Video:uOqtqJ6TjEE	Channel:UC_dkX2_MJZeiYZImFN8AOvg
eSportsDolo & Hi-Hatz vs. Riot & VGR DMG|Ross - Teams Winners Finals - SC52	Video:RgZCDijrCPU	Channel:UC_dkX2_MJZeiYZImFN8AOvg
Mew2King vs. a mosquito - lol	Video:KtWz7WXS0uY	Channel:UC_dkX2_MJZeiYZImFN8AOvg
2 Quick Ones - Ryo vs. Mew2King	Video:_d3LwQTh3x8	Channel:UC_dkX2_MJZeiYZImFN8AOvg
Smash Conference 51: Mew2King Winner's Interview	Video:4bqU9taeRAM	Channel:UC_dkX2_MJZeiYZImFN8AOvg
COG MVG|Mew2King (Cloud) vs. MVG|Ryo (Corrin) - Grand Finals - SC51	Video:RS2nzTnC7O8	Channel:UC_dkX2_MJZeiYZImFN8AOvg
ONI|Day (Lucario) vs. MVG|Ryo (Corrin) - Losers Finals - SC51	Video:g45ISKuCY_A	Channel:UC_dkX2_MJZeiYZImFN8AOvg
ONI|Day (Lucario) vs. RoguePenguin (Mario) - Losers Semis - SC51	Video:tsLXP7HuBxc	Channel:UC_dkX2_MJZeiYZImFN8AOvg
COG MVG|Mew2King (Cloud) vs. MVG|Ryo (Corrin, Roy, & Ike) - Winners Finals - SC51	Video:gfrfSiMGbgs	Channel:UC_dkX2_MJZeiYZImFN8AOvg
ONI|Day (Lucario) vs. Saj (Bayonetta) - Losers Quarters - SC51	Video:_0qPcFEV0sQ	Channel:UC_dkX2_MJZeiYZImFN8AOvg
Rupour (Ness) vs. RoguePenguin (Mario) - Losers Quarters - SC51	Video:DM9ua8OwVLE	Channel:UC_dkX2_MJZeiYZImFN8AOvg
ONI|Day (Lucario) vs. O Rocket (Diddy) - Losers R8 - SC51	Video:tUDTspJKWlo	Channel:UC_dkX2_MJZeiYZImFN8AOvg
RoguePenguin (Mario) vs. Noble|Sol (Little Mac) - Losers R8 - SC51	Video:lDS_BISCSLg	Channel:UC_dkX2_MJZeiYZImFN8AOvg
YEEE (Rosalina) vs. Noble|Sol (Little Mac) - Losers R7 - SC51	Video:JGVGwIbzOzA	Channel:UC_dkX2_MJZeiYZImFN8AOvg
COG MVG|Mew2King (Cloud) vs. Rupour (Ness) - Winners Semis - SC51	Video:qrPAY-NPcQE	Channel:UC_dkX2_MJZeiYZImFN8AOvg
MVG|Ryo (Corrin) vs. Saj (Bayonetta) - Winners Semis - SC51	Video:tc0YJ9MJxIg	Channel:UC_dkX2_MJZeiYZImFN8AOvg
Rupour (Ness) vs. ONI|Day (Lucario) - Winners Quarters - SC51	Video:iRx8xv49s7g	Channel:UC_dkX2_MJZeiYZImFN8AOvg
O Rocket (Diddy) vs. COG MVG|Mew2King (Cloud) - Winners Quarters - SC51	Video:nf6EH0FQScM	Channel:UC_dkX2_MJZeiYZImFN8AOvg
Noble|Sol (Little Mac) vs. Hi-Hatz (Ganondorf) - Winners Quarters - SC51	Video:k_sJEB2NcRU	Channel:UC_dkX2_MJZeiYZImFN8AOvg
Noble|Sol (Little Mac) vs. GxFire (Corrin & Lucina) - Winners Quarters - SC51	Video:JfEfVoz5B68	Channel:UC_dkX2_MJZeiYZImFN8AOvg
MVG|Ryo (Corrin) vs. Paradise (Mewtwo) - Winners Quarters - SC51	Video:-eW6p4fRUOY	Channel:UC_dkX2_MJZeiYZImFN8AOvg
MVG|Ryo & Noble|Sol vs. COG MVG|Mew2King & ONI|Day - Teams Grand Finals - SC51	Video:0G4D5zMe9bk	Channel:UC_dkX2_MJZeiYZImFN8AOvg
Hiroi & Saj vs. COG MVG|Mew2King & ONI|Day - Teams Losers Finals - SC51	Video:4b3dIHX4M5E	Channel:UC_dkX2_MJZeiYZImFN8AOvg
Hiroi & Saj vs. Paradise & Jabe - Teams Losers Semis - SC51	Video:LhPhTOz2fZk	Channel:UC_dkX2_MJZeiYZImFN8AOvg
Hiroi & Saj vs. Jag & YEEE - Teams Losers Quarters - SC51	Video:pZNmJQGk9p8	Channel:UC_dkX2_MJZeiYZImFN8AOvg
COG MVG|Mew2King & ONI|Day vs. Noble|Sol & MVG|Ryo - Teams Winners Finals - SC51	Video:Vh75aDU1RZs	Channel:UC_dkX2_MJZeiYZImFN8AOvg
YEEE & Jag vs. Noble|Sol & MVG|Ryo - Teams Winners R3 - SC51	Video:8JthBD1N1OQ	Channel:UC_dkX2_MJZeiYZImFN8AOvg
GxFire & Crabby vs. 7 & MVG|CherubiKnighT - Teams Winners R2 - SC51	Video:lVFrLD65RSM	Channel:UC_dkX2_MJZeiYZImFN8AOvg
YEEE & Jag vs. Hala & GX2 - Teams Winners R2 - SC51	Video:nPcDuEHjQO4	Channel:UC_dkX2_MJZeiYZImFN8AOvg
NaCI & Casey Lounge vs. COG MVG|Mew2King & ONI|Day - Teams Winners R2 - SC51	Video:T7wq1jJU3YQ	Channel:UC_dkX2_MJZeiYZImFN8AOvg
DOUBLE FISTING in SMASH	Video:6tU7ybstEzs	Channel:UC_dkX2_MJZeiYZImFN8AOvg
Mew2King vs. 7 (Link), Saj (Bayo), CrazieCuban (T. Link) - Exhibition Crew Battle	Video:S-d1Zqn-Zt8	Channel:UC_dkX2_MJZeiYZImFN8AOvg
MVG|Ryo (Corrin) vs. 7 (Link) - Bad Blood Exhibition Match - 1st to 5	Video:7fi1OYCW53A	Channel:UC_dkX2_MJZeiYZImFN8AOvg
Ike's Sacred Combo! (Ryo)	Video:71zxD5e6G4M	Channel:UC_dkX2_MJZeiYZImFN8AOvg
Mew2King vs. Saj - Bayonetta Ditto - Post Tournament Exhibition Matches	Video:0LapUbZXKRg	Channel:UC_dkX2_MJZeiYZImFN8AOvg
Saj (Bayonetta) vs. CrazieCuban (Toon Link, Greninja, & Jigglypuff) - Grand Finals - SC50	Video:6VgMVJAXxrM	Channel:UC_dkX2_MJZeiYZImFN8AOvg
Saj (Bayonetta) vs. ONI|Day (ZSS) - Losers Finals - SC50	Video:lltghndsB_Y	Channel:UC_dkX2_MJZeiYZImFN8AOvg
Saj (Bayonetta) vs. 7 (Link) - Losers Semis - SC50	Video:e0Cjc2i8Bv4	Channel:UC_dkX2_MJZeiYZImFN8AOvg
ONI|Day (ZSS) vs. CrazieCuban (Toon Link & Jigglypuff) - Winners Finals - SC50	Video:AHhCQsOgIag	Channel:UC_dkX2_MJZeiYZImFN8AOvg
MVG|Ryo (Corrin) vs. CrazieCuban (Toon Link) - Winners Semis - SC50	Video:ofymjWiD2cU	Channel:UC_dkX2_MJZeiYZImFN8AOvg
eSportsDolo (ROB) vs. MVG|Ryo (Corrin) - Winners Quarters - SC50	Video:V9x-Hdn7HT0	Channel:UC_dkX2_MJZeiYZImFN8AOvg
ONI Day (ZSS) vs. Hi-Hatz (Ganondorf) - Winners Semis - SC50	Video:G0rG_P6MvAo	Channel:UC_dkX2_MJZeiYZImFN8AOvg
CrazieCuban (Toon Link) vs. 0 Rocket (Diddy) - Winners Quarters - SC50	Video:KqK0vTDnZ5c	Channel:UC_dkX2_MJZeiYZImFN8AOvg
eSportsDolo & Hi-Hatz vs. MVG|COG Mew2King & ONI|Day - Teams Grand Finals - SC50	Video:34qY-4b2LFo	Channel:UC_dkX2_MJZeiYZImFN8AOvg
eSportsDolo & Hi-Hatz vs. GX2 & Saj - Teams Losers Finals - SC50	Video:69QLFkpcfUs	Channel:UC_dkX2_MJZeiYZImFN8AOvg
eSportsDolo & Hi-Hatz vs. CrazyCuban & 7 - Teams Losers Semis - SC50	Video:cPKBdaRU8Gw	Channel:UC_dkX2_MJZeiYZImFN8AOvg
GX2 & Saj vs. MVG|COG Mew2King & ONI|Day - Teams Winners Finals - SC50	Video:QzBK3XSYGK4	Channel:UC_dkX2_MJZeiYZImFN8AOvg
Corrin Beginner's Guide (Mew2King) - Super Smash Bros. Wii U	Video:SHy_ua0bwtQ	Channel:UC_dkX2_MJZeiYZImFN8AOvg
Mew2King Dab	Video:1wlWOGnuP9A	Channel:UC_dkX2_MJZeiYZImFN8AOvg
Bayonetta Beginner's Competitive Guide (Mew2King) - Super Smash Bros. Wii U	Video:pnbfeaHpKJ8	Channel:UC_dkX2_MJZeiYZImFN8AOvg
Mew2King (Bayonetta) vs. Ryo (Corrin) - 5 Stock Matches	Video:fjJte83DbXA	Channel:UC_dkX2_MJZeiYZImFN8AOvg
Ryo (Corrin) vs. Mew2King (Cloud) - Exhibition Match	Video:aqbuSDmU3nY	Channel:UC_dkX2_MJZeiYZImFN8AOvg
CherubiKnighT (Corrin) vs. Mew2King (Bayonetta) - Exhibition Match	Video:5b3HM3YvUYM	Channel:UC_dkX2_MJZeiYZImFN8AOvg
Bayonetta Dittos - Mew2King vs. GX2 - 5 Stock Match	Video:zjeOCT9wGUI	Channel:UC_dkX2_MJZeiYZImFN8AOvg
Bayonetta Dance Off Gone Wrong - Mew2King	Video:gbnS2WAmSHo	Channel:UC_dkX2_MJZeiYZImFN8AOvg
Ally (Villager) vs. Mew2King (Cloud) - Exhibition Match	Video:nIAtI23dm60	Channel:UC_dkX2_MJZeiYZImFN8AOvg
The Best Cloud vs. The Best Ike - Mew2King vs. Ryo - Exhibition Battle	Video:b3LbYoCFasQ	Channel:UC_dkX2_MJZeiYZImFN8AOvg
Random Thoughts with Mew2King and CherubiKnighT	Video:a8OCurNWC5k	Channel:UC_dkX2_MJZeiYZImFN8AOvg
Ally (Shulk) vs. Mew2King (Cloud) - Exhibition Match	Video:OYcsdI_-zzk	Channel:UC_dkX2_MJZeiYZImFN8AOvg
Ally (Diddy) vs. Mew2King (Cloud) - Exhibition Match	Video:IcDt846co2I	Channel:UC_dkX2_MJZeiYZImFN8AOvg
Ally (Marth) vs. Mew2King (Cloud) - Exhibition Match	Video:1fX1o-I2CoE	Channel:UC_dkX2_MJZeiYZImFN8AOvg
Ally (Mario) vs. Mew2King (Cloud) - Exhibition Match	Video:-8bI37ZSEcU	Channel:UC_dkX2_MJZeiYZImFN8AOvg
Mew2King 3 STOCKS Ryo - Cloud vs. Roy	Video:35yM2EdaenE	Channel:UC_dkX2_MJZeiYZImFN8AOvg
Random Mew2King Cloud Clips, Thoughts, and Funny Moments	Video:7gpUKDUmS64	Channel:UC_dkX2_MJZeiYZImFN8AOvg
Funny Mew2King Fails - Super Smash Bros, Wii U	Video:roweYrG09xw	Channel:UC_dkX2_MJZeiYZImFN8AOvg
Mew2King (Cloud) vs. 8BitMan (ROB) - Exhibition Match	Video:Sy2iPVTKPoo	Channel:UC_dkX2_MJZeiYZImFN8AOvg
Mew2King (Cloud) vs.  Day (ZSS) - Exhibition Match	Video:2IH_OylH8ak	Channel:UC_dkX2_MJZeiYZImFN8AOvg
Another Way to Recover that Snaps to the Ledge with Cloud - Mew2King	Video:vhmo_GIrWv4	Channel:UC_dkX2_MJZeiYZImFN8AOvg
Cloud "For Glory" Run (Mew2King)	Video:nvXEK6-CSCw	Channel:UC_dkX2_MJZeiYZImFN8AOvg
CLOUD DITTOS EXHIBITION - Mew2King vs. Ryo - Super Smash Bros. Wii U	Video:c2-0VIQJgO0	Channel:UC_dkX2_MJZeiYZImFN8AOvg
Cloud In Depth Moveset  and Combo Competitive Guide (Mew2King) - Super Smash Bros. Wii U	Video:E8CFggYa_Gs	Channel:UC_dkX2_MJZeiYZImFN8AOvg
Mew2King (Cloud) vs.  Ryo (Ike) - Friendly Matches	Video:Gv6uBdmdLww	Channel:UC_dkX2_MJZeiYZImFN8AOvg
Mew2King and the ENTIRE SMASH DIRECT!	Video:G3sbPPj6nc8	Channel:UC_dkX2_MJZeiYZImFN8AOvg
Mew2King REACTS TO BAYONETTA!!!!!!!!!!	Video:FgOrAyEhyY8	Channel:UC_dkX2_MJZeiYZImFN8AOvg
Mew2King REACTS TO CORRIN!!!!!!!	Video:1WsoCT3zNL8	Channel:UC_dkX2_MJZeiYZImFN8AOvg
Ganondorf shows NO MERCY - (Ryo)	Video:6QiIv38vR1o	Channel:UC_dkX2_MJZeiYZImFN8AOvg
Ryo's Captain Falcon is the TRUTH	Video:d7dq_IBGgqA	Channel:UC_dkX2_MJZeiYZImFN8AOvg
King Dedede Jet Hammer CHICKEN	Video:4ayBcH-4PdA	Channel:UC_dkX2_MJZeiYZImFN8AOvg
Rupour (Ness & Mario) vs. DewDaDash (Diddy) - Grand Finals - SC48	Video:q3gid6R2NBA	Channel:UC_dkX2_MJZeiYZImFN8AOvg
Rupour (Ness) vs. RoguePenguin (Mario) - Losers Finals - SC48	Video:v9Rwea0vgRo	Channel:UC_dkX2_MJZeiYZImFN8AOvg
Saj (Link) vs. RoguePenguin (Mario) - Losers Finals - SC48	Video:0FoDddSrEb0	Channel:UC_dkX2_MJZeiYZImFN8AOvg
7 (Link) vs. RoguePenguin (Mario) - Losers Quarters - SC48	Video:Unr7vq0qWRs	Channel:UC_dkX2_MJZeiYZImFN8AOvg
Tayne (Peach) vs. Saj (Link) - Losers R5 - SC48	Video:KmH0klH7IAw	Channel:UC_dkX2_MJZeiYZImFN8AOvg
DewDaDash (Diddy) vs. Rupour (Ness) - Winners Finals - SC48	Video:xXlF8nL_cz0	Channel:UC_dkX2_MJZeiYZImFN8AOvg
7 (Meta Knight) vs. Rupour (Ness) - Winners R5 - SC48	Video:0WE1UKdoiK4	Channel:UC_dkX2_MJZeiYZImFN8AOvg
7 (Meta Knight) vs. C-Rez (C.Falcon & G&W) - Winners R4 - SC48	Video:5dFDNKFuIXs	Channel:UC_dkX2_MJZeiYZImFN8AOvg
O Rocket (Diddy) vs. RoguePenguin (Mario) - Winners R4 - SC48	Video:nk35qtmXGgM	Channel:UC_dkX2_MJZeiYZImFN8AOvg
Hi-Hatz (Ganon) vs. Rupour (Ness) - Winners R3 - SC48	Video:PbFE2YOZxyM	Channel:UC_dkX2_MJZeiYZImFN8AOvg
Crodd (Luigi) vs. ATR|CherubiKnight (Lucina) - Winners R2 - SC48	Video:fxC7p8DlNPE	Channel:UC_dkX2_MJZeiYZImFN8AOvg
Rupour & DewDaDash vs. Jag & RoguePenguin - Teams Grand Finals - SC48	Video:YTmN_kVMDOo	Channel:UC_dkX2_MJZeiYZImFN8AOvg
Hala & Hi-Hatz vs. Jag & RoguePenguin - Teams Losers Finals - SC48	Video:Ez58OwWwzUI	Channel:UC_dkX2_MJZeiYZImFN8AOvg
YEEE & ROB vs. Jag & RoguePenguin - Teams Losers Semis - SC48	Video:iUvEKR_LAos	Channel:UC_dkX2_MJZeiYZImFN8AOvg
VS|NickRiddle (ZSS) vs. GOTE|8BitMan (ROB) - GRAND FINALS - FPS	Video:zaK8lSdHjh8	Channel:UC_dkX2_MJZeiYZImFN8AOvg
DJ Jack (Mario & Ryu) vs. GOTE|8BitMan (ROB) - Losers Finals - FPS	Video:QX7pAMn28tI	Channel:UC_dkX2_MJZeiYZImFN8AOvg
DJ Jack (Ryu) vs. PG|Esam (Yoshi & Pikachu) - Losers Semis - FPS	Video:diXIVvIaOpU	Channel:UC_dkX2_MJZeiYZImFN8AOvg
GOTE|8BitMan (Diddy) vs. VS|NickRiddle (ZSS) - Winners Finals - FPS	Video:LNmFyXM2sgY	Channel:UC_dkX2_MJZeiYZImFN8AOvg
VS|NickRiddle (ZSS) vs. Xaltis (Rosalina) - Winners Semis - FPS	Video:Osx9DnnwQRQ	Channel:UC_dkX2_MJZeiYZImFN8AOvg
GOTE|8BitMan (ROB) vs. Fatality (C. Falcon) - Winners Semis - FPS	Video:Geqj9_hgkRc	Channel:UC_dkX2_MJZeiYZImFN8AOvg
MVG|Ryo (Ike) vs. PG|Esam (Pikachu) - Top 16 Losers - FPS	Video:SBymA1o7oNE	Channel:UC_dkX2_MJZeiYZImFN8AOvg
MVG|Ryo (Ike) vs. VS|NickRiddle (ZSS) - Winners Quarters - FPS	Video:aPlzMjxIWCU	Channel:UC_dkX2_MJZeiYZImFN8AOvg
Fatality (C. Falcon) vs. Dath (Robin) - Winners Quarters - FPS	Video:mWf4EIWB4eg	Channel:UC_dkX2_MJZeiYZImFN8AOvg
VGR|Ross (Toon Link) vs. PG|MVD (Diddy) - Top 16 Winners - FPS	Video:ZjoawLgZTE8	Channel:UC_dkX2_MJZeiYZImFN8AOvg
DJ Jack (Ryu) vs. PG|Esam (Pikachu) - Top 16 Winners - FPS	Video:ZYCCnoArMvA	Channel:UC_dkX2_MJZeiYZImFN8AOvg
Saj (Peach) vs. Dath (Robin) - Pools - FPS	Video:Es8arG_GJz0	Channel:UC_dkX2_MJZeiYZImFN8AOvg
DJ Jack (Ryu) vs. Dyr (Diddy) - Pools - FPS	Video:Gs2lk9r-7c8	Channel:UC_dkX2_MJZeiYZImFN8AOvg
MVG|Ryo (Ike) vs. MasterRaven (Sheik) - Pools - FPS	Video:0MHhcisCWxE	Channel:UC_dkX2_MJZeiYZImFN8AOvg
MVG|Sol (Little Mac) vs. DJ Jack (Ryu) - Pools - FPS	Video:2_W08CMmYLw	Channel:UC_dkX2_MJZeiYZImFN8AOvg
MasterRaven (Sheik) vs. StreetShark (Pit) - Pools - FPS	Video:8iBKX6AhlFA	Channel:UC_dkX2_MJZeiYZImFN8AOvg
BC|PurpleGuy (Sheik) vs. VGR|Ross (Toon Link) - Pools - FPS	Video:wB2AwNnC9y4	Channel:UC_dkX2_MJZeiYZImFN8AOvg
Saj (Peach) vs. Dath (Robin) - Pools - FPS	Video:M_gcnYDeHHM	Channel:UC_dkX2_MJZeiYZImFN8AOvg
Prince Ramen (Palutena) vs. Hiroi (ZSS) - Pools - FPS	Video:nqqLGF06MQY	Channel:UC_dkX2_MJZeiYZImFN8AOvg
MVG|Ryo (Ike) vs. Volc (Yoshi) - Pools - FPS	Video:P2nww33KRog	Channel:UC_dkX2_MJZeiYZImFN8AOvg
SSHQ|GDX (Diddy) vs. Afmbot (Donkey Kong) - Pools - FPS	Video:j22GBfqaWi8	Channel:UC_dkX2_MJZeiYZImFN8AOvg
DJ Jack (Ryu) vs. Poltergust (Yoshi) - Pools - FPS	Video:oxw02fHe3-U	Channel:UC_dkX2_MJZeiYZImFN8AOvg
Hala (Marth) vs. MVG|Sol (Little Mac) - Pools - FPS	Video:SnS4aAXZ4ew	Channel:UC_dkX2_MJZeiYZImFN8AOvg
GOTE|8BitMan (ROB) vs. Fatality (C. Falcon) - POOLS - FPS	Video:hBQwXaVyLZU	Channel:UC_dkX2_MJZeiYZImFN8AOvg
Cashmere (C. Falcon) vs. Xaltis (Rosalina) - Pools Losers Finals - FPS	Video:yzYDAjNvxjw	Channel:UC_dkX2_MJZeiYZImFN8AOvg
DewDaDash (Diddy) vs. Fatality (C. Falcon) - Pools - FPS	Video:EYpGJsczDTw	Channel:UC_dkX2_MJZeiYZImFN8AOvg
Tremendo Dude (Shulk) vs. PG|MVD (Diddy) - Pools - FPS	Video:it4TPXGO37Q	Channel:UC_dkX2_MJZeiYZImFN8AOvg
ONI|Day (Lucario) vs. PG|Esam (Pikachu) - Pools Winners Finals - FPS	Video:qbgMwWk-azk	Channel:UC_dkX2_MJZeiYZImFN8AOvg
Cashmere (C.Falcon) vs. ONI|Heero (Sonic & Roy) - Winners R2 - FPS	Video:Uqx-X8Cs7uo	Channel:UC_dkX2_MJZeiYZImFN8AOvg
Rideae (Pikachu) vs. Fatality (C.Falcon) - Winners R2 - FPS	Video:zySsS0vNo2k	Channel:UC_dkX2_MJZeiYZImFN8AOvg
CFS|TrueBlue (Sonic) vs. ONI|Day (Lucario) - Winners R2 - FPS	Video:zR5HhWW0-ZE	Channel:UC_dkX2_MJZeiYZImFN8AOvg
Tachyon (Pikachu) vs. Kipa (Pikachu) - Winners R1 - FPS	Video:YbQnz4-GKCE	Channel:UC_dkX2_MJZeiYZImFN8AOvg
ONI|Day (Lucario) vs. JaK (Diddy) - Winners R1 - FPS	Video:ErPBsp_MBB0	Channel:UC_dkX2_MJZeiYZImFN8AOvg
Brand (R.O.B.) vs. CFS|TrueBlue (Sonic) - Winners R1 - FPS	Video:soWzr9Uu3i0	Channel:UC_dkX2_MJZeiYZImFN8AOvg
PG|MVD & PG|Esam vs. ONI|Heero & ONI|Day - Grand Finals - FPS	Video:HSFJgdHspuc	Channel:UC_dkX2_MJZeiYZImFN8AOvg
PG|MVD & PG|Esam vs. Xaltis & DJ Jack - Losers Finals - FPS	Video:zd3PsuLjXBI	Channel:UC_dkX2_MJZeiYZImFN8AOvg
MVG|Ryo & MVG|Sol vs. Xaltis & DJ Jack - Losers Semis - FPS	Video:a8pZ9eclQFs	Channel:UC_dkX2_MJZeiYZImFN8AOvg
PG|MVG & PG|Esam vs. VS|NickRiddle & COG MVG|Mew2King - Winners R4 - FPS	Video:Rz941GphHWw	Channel:UC_dkX2_MJZeiYZImFN8AOvg
PG|MVD & PG|Esam vs.ONI|Heero & ONI|Day - Winners Finals - FPS	Video:Xq8g8s53Upg	Channel:UC_dkX2_MJZeiYZImFN8AOvg
ONI|StaticManny & ONI|Day vs. MVG|Ryo & MVG|Sol - Winners R4 - FPS	Video:0smdcaRZSfg	Channel:UC_dkX2_MJZeiYZImFN8AOvg
ONI|Day & ONI|StaticManny vs. DJ Jack & Xaltis - Winners R3 - FPS	Video:G2yJTWhLsDE	Channel:UC_dkX2_MJZeiYZImFN8AOvg
PG|MVD & PG|Esam vs. Seibrik & MasterRaven - Winners R3 - FPS	Video:hjYjB0mOLd0	Channel:UC_dkX2_MJZeiYZImFN8AOvg
VS|NickRiddle & COG MVG|Mew2King vs. GOTE|8BitMan & BC|PurpleGuy - Winners R3 - FPS	Video:qIejOBRYdUs	Channel:UC_dkX2_MJZeiYZImFN8AOvg
MVG|Ryo & MVG|Sol vs. Darth & CFS|TrueBlue - Winners R3 - FPS	Video:b_O4lr6Ay4I	Channel:UC_dkX2_MJZeiYZImFN8AOvg
Streetshark & SSHQ|GDX vs. Seibrik & MasterRaven - Winners R2 - FPS	Video:kiFgjKgfmpE	Channel:UC_dkX2_MJZeiYZImFN8AOvg
MVG|Sol (Little Mac) vs. Afmbot (Donkey Kong) - SSB4 Winners Finals - SC47	Video:IblF0THUcg0	Channel:UC_dkX2_MJZeiYZImFN8AOvg
MVG|Sol vs. MVG|Ryo - SSB4 Grand Finals - SC47	Video:BWlAfw3PZfo	Channel:UC_dkX2_MJZeiYZImFN8AOvg
Afmbot (Donkey Kong) vs. MVG|Ryo (D. Mario & Ike) - SSB4 Losers Finals - SC47	Video:DVaX-v2xfc4	Channel:UC_dkX2_MJZeiYZImFN8AOvg
Tachyon (Pikachu & Duck Hunt) vs. MVG|Ryo (Little Mac) - SSB4 Losers Semis - SC47	Video:_LXBicMW03o	Channel:UC_dkX2_MJZeiYZImFN8AOvg
Tachyon (Pikachu) vs. RoguePenguin (Mario) - SSB4 Losers R9 - SC47	Video:ESoEQzIOXuM	Channel:UC_dkX2_MJZeiYZImFN8AOvg
MVG|Sol (Little Mac) vs. Tachyon (Pikachu) - SSB4 Winners Semis - SC47	Video:mm55MqydQ_c	Channel:UC_dkX2_MJZeiYZImFN8AOvg
Tayne (Peach) vs. Afmbot (Donkey Kong) - SSB4 Winners R5 - SC47	Video:e6TC9q7CwRQ	Channel:UC_dkX2_MJZeiYZImFN8AOvg
CrazieCuban (Toon Link) vs. MVG|Sol (Little Mac) - SSB4 Winners R5 - SC47	Video:cdLnGJRv08g	Channel:UC_dkX2_MJZeiYZImFN8AOvg
Tachyon (Pikachu) vs. YEEE (Rosalina) - SSB4 Winners R4 - SC47	Video:KsDbNOJlJ3E	Channel:UC_dkX2_MJZeiYZImFN8AOvg
RoguePenguin (Mario) vs. Afmbot (Donkey Kong) - SSB4 Winners R5 - SC47	Video:YSry-GkeGTk	Channel:UC_dkX2_MJZeiYZImFN8AOvg
ATR|CherubiKnight (Lucina) vs. Tachyon (Pikachu) - SSB4 Winners R4 - SC47	Video:XmdSl_TSehU	Channel:UC_dkX2_MJZeiYZImFN8AOvg
Jahbna (ZSS) vs. RoguePenguin (Mario) - SSB4 Winners R5 - SC47	Video:HCFKtk866iw	Channel:UC_dkX2_MJZeiYZImFN8AOvg
eSportsDolo (ROB) vs. Afmbot (Donkey Kong) - SSB4 Winners R4 - SC47	Video:yKFkiWX9MuA	Channel:UC_dkX2_MJZeiYZImFN8AOvg
VGR|Fil (Mario) vs. CherubiKnight (Lucina) - SSB4 Winners R3 - SC47	Video:874PeM6GhWw	Channel:UC_dkX2_MJZeiYZImFN8AOvg
MVG|Ryo & MVG|Sol vs. ONI|Day & Tachyon - SSB4 Grand Finals - SC47	Video:Ul9sX4nFJIQ	Channel:UC_dkX2_MJZeiYZImFN8AOvg
Jag & Jeck vs. ONI|Day & Tachyon - SSB4 Losers Finals - SC47	Video:gQ6DERklPNI	Channel:UC_dkX2_MJZeiYZImFN8AOvg
Jag & Jeck vs. CrazieCuban & ArcticFox - SSB4 Losers Semis - SC47	Video:sfWEBVr84Wg	Channel:UC_dkX2_MJZeiYZImFN8AOvg
RoguePenguin & SnarkyFox vs. CrazieCuban & ArcticFox - Losers R5 - SC47	Video:6zRjGxHgR1k	Channel:UC_dkX2_MJZeiYZImFN8AOvg
MVG|Ryo & MVG|Sol vs. CrazieCuban & ArcticFox - SSB4 Winners Semis - SC47	Video:qlVbnQ8bBi4	Channel:UC_dkX2_MJZeiYZImFN8AOvg
MVG|Ryo & MVG|Sol vs. Tachyon & ONI|Day - SSB4 Winners Finals - SC47	Video:tB_qOFDSnhk	Channel:UC_dkX2_MJZeiYZImFN8AOvg
Tachyon & ONI|Day vs. Jag & Jeck - SSB4 Winners Semis - SC47	Video:VgCI7RIAqtg	Channel:UC_dkX2_MJZeiYZImFN8AOvg
ArcticFox & CrazieCuban vs. Afmbot & VGR|Fil - SSB4 Winners R3 - SC47	Video:RdJLgGLZOvE	Channel:UC_dkX2_MJZeiYZImFN8AOvg
Tachyon & ONI|Day vs. SnarkyFox & RoguePenguin - SSB4 Winners R3 - SC47	Video:G-WObGy7RdM	Channel:UC_dkX2_MJZeiYZImFN8AOvg
MVG|Sol's AMAZING Blindfolded Contender Run (+Glass Joe Gag)	Video:UtJqMRO__uA	Channel:UC_dkX2_MJZeiYZImFN8AOvg
Special #ExtraLife moment w/ Nathan and Mr. DadeX	Video:9AFCFgMYkH4	Channel:UC_dkX2_MJZeiYZImFN8AOvg
Dyr Winner's Interview - Gatorlan Fall 2015	Video:sX8QC5FYDoE	Channel:UC_dkX2_MJZeiYZImFN8AOvg
Gatorlan: Dyr (Diddy) vs. MVG|Ryo (Ike) - Grand Finals	Video:wfQhgYQSX2Q	Channel:UC_dkX2_MJZeiYZImFN8AOvg
Gatorlan: ONI|Heero (Sonic) vs. MVG|Ryo (Ike) - Losers Finals	Video:m3udLmhleow	Channel:UC_dkX2_MJZeiYZImFN8AOvg
Gatorlan: Dyr (Diddy) vs. MVG|Ryo (D. Mario & Ike) - Winners Finals	Video:0oKe4z1o-DY	Channel:UC_dkX2_MJZeiYZImFN8AOvg
Gatorlan: ONI|Heero (Sonic) vs. ARC|Myran (Olimar) - Losers Semis	Video:RZJHk__pfdw	Channel:UC_dkX2_MJZeiYZImFN8AOvg
Gatorlan: 1738 (Diddy) vs. ARC|Myran (Olimar) - Losers Top 8	Video:Yirf7QCAgw0	Channel:UC_dkX2_MJZeiYZImFN8AOvg
Gatorlan: VGR|Ross (Toon Link & Shulk) vs. ONI|Heero (Sonic & Roy) - Losers Top 8	Video:Re0LVaec1n0	Channel:UC_dkX2_MJZeiYZImFN8AOvg
Gatorlan: Poltergust (Luigi) vs. 1738 (Diddy) - Losers Top 8	Video:F0WBcZBjH0g	Channel:UC_dkX2_MJZeiYZImFN8AOvg
Gatorlan: Afmbot (Donkey Kong) vs. VGR|Ross (Toon Link) - Losers Top 8	Video:SqoDy-fE0Ds	Channel:UC_dkX2_MJZeiYZImFN8AOvg
Gatorlan: Dyr (Diddy) vs. ARC|Myran (Olimar) - Winners Semis	Video:UkOhlw5WioQ	Channel:UC_dkX2_MJZeiYZImFN8AOvg
Gatorlan: MVG|Ryo (Ike & D. Mario) vs. ONI|Heero (Roy & Sonic) - Winners Semis	Video:jSpq055d5jY	Channel:UC_dkX2_MJZeiYZImFN8AOvg
Gatorlan: Prince Ramen (Palutena) vs. 1738 (Diddy) - Losers Top 16	Video:BGlp_gBximw	Channel:UC_dkX2_MJZeiYZImFN8AOvg
Gatorlan: MVG|Ryo (Ike) vs. Poltergust (Yoshi) - Winners Top 16	Video:kU4TWfYi4DQ	Channel:UC_dkX2_MJZeiYZImFN8AOvg
Gatorlan: Dyr (Diddy) vs. VGR|Ross (Toon Link) - Winners Top 16	Video:kE8hZJCFt7g	Channel:UC_dkX2_MJZeiYZImFN8AOvg
Gatorlan: MVG|Sol (Little Mac) vs. ARC|Myran (Olimar) - Winners Top 16	Video:NU3nXejJEMM	Channel:UC_dkX2_MJZeiYZImFN8AOvg
Gatorlan - Liquid' NuckleDu vs. Fit3amie - Grand Finals - USFIV	Video:WdW4usjjm6A	Channel:UC_dkX2_MJZeiYZImFN8AOvg
Gatorlan - Liquid' NuckleDu vs. B Cole - Losers Finals - USFIV	Video:xoHO2TagKhM	Channel:UC_dkX2_MJZeiYZImFN8AOvg
Gatorlan - GatorDining vs. B Cole - Losers Quarters - USFIV	Video:PNhp0nBLAW0	Channel:UC_dkX2_MJZeiYZImFN8AOvg
Gatorlan - SkyViper vs. B Cole - Losers Semis - USFIV	Video:xMcS-UR_INo	Channel:UC_dkX2_MJZeiYZImFN8AOvg
Gatorlan - GatorDining vs. Dejafait - Losers R7 - USFIV	Video:yW3bMjH8E0I	Channel:UC_dkX2_MJZeiYZImFN8AOvg
Gatorlan - GatorDining vs. SSHQ | GDX - Losers R6 - USFIV	Video:GxxRqLSlrzg	Channel:UC_dkX2_MJZeiYZImFN8AOvg
Gatorlan - GatorDining vs. DarkWraithSnow - Losers R5 - USFIV	Video:VjXTaK43p-M	Channel:UC_dkX2_MJZeiYZImFN8AOvg
Gatorlan - Fit3amie vs. Liquid' NuckleDu - Winners Finals - USFIV	Video:3lfPrdCBwCI	Channel:UC_dkX2_MJZeiYZImFN8AOvg
Gatorlan - Drenxan87 vs. Bob Custom Gamer - Losers R4 - USFIV	Video:iKRdGE1_jR4	Channel:UC_dkX2_MJZeiYZImFN8AOvg
Gatorlan - Skyviper vs. Liquid' NuckleDu - Winners Finals - USFIV	Video:5gzXloywWt8	Channel:UC_dkX2_MJZeiYZImFN8AOvg
Gatorlan - Skyviper vs. Afmbot - Winners Semis - USFIV	Video:x0758O21Ckg	Channel:UC_dkX2_MJZeiYZImFN8AOvg
Gatorlan - B Cole vs. Fit3amie - Winners Semis - USFIV	Video:3MflcA0turs	Channel:UC_dkX2_MJZeiYZImFN8AOvg
Gatorlan - Jox in a Box vs. Fit3amie - Winners R4 - USFIV	Video:-0BCcueNPUI	Channel:UC_dkX2_MJZeiYZImFN8AOvg
Gatorlan - Afmbot vs. Poppa Riggs - Winners R3 - USFIV	Video:lM6dgTuwKFo	Channel:UC_dkX2_MJZeiYZImFN8AOvg
Gatorlan - SSHQ | GDX vs. Liquid' NuckleDu - Winners R4 - USFIV	Video:JpnmcWe0fy0	Channel:UC_dkX2_MJZeiYZImFN8AOvg
Gatorlan - Fit3amir vs. John - Winners R3 - USFIV	Video:omc0ImqbznM	Channel:UC_dkX2_MJZeiYZImFN8AOvg
Gatorlan - B Cole vs. Frank Lotion - Winners R2 - USFIV	Video:2W6QIXPGz6w	Channel:UC_dkX2_MJZeiYZImFN8AOvg
Gatorlan - Liquid' NuckleDu vs. XK1 - Winners R3 - USFIV	Video:jD_3dElAUrY	Channel:UC_dkX2_MJZeiYZImFN8AOvg
Gatorlan - GatorDining vs. RagingStormX - Winners R1 - USFIV	Video:qdz7WE5Ayl4	Channel:UC_dkX2_MJZeiYZImFN8AOvg
Gatorlan - BobCustomGaming vs. SkyViper - Winners R1 - USFIV	Video:TCOPOn-KgFU	Channel:UC_dkX2_MJZeiYZImFN8AOvg
YEEE (Rosalina) vs. MVG|Ryo (C.Falcon) - SSB4 Grand Finals - SC46	Video:DnL36p1TPyo	Channel:UC_dkX2_MJZeiYZImFN8AOvg
YEEE (Rosalina) vs. Oni Day (ZSS) - SSB4 Losers Quarters - SC46	Video:pfrpCojtcOY	Channel:UC_dkX2_MJZeiYZImFN8AOvg
YEEE (Rosalina) vs. RoguePenguin (Mario) - SSB4 Losers Finals - SC46	Video:JeppID_ajug	Channel:UC_dkX2_MJZeiYZImFN8AOvg
YEEE (Rosalina) vs. Crabby (Dark Pit) - SSB4 Losers Semis - SC46	Video:ZmvAtDNI7W0	Channel:UC_dkX2_MJZeiYZImFN8AOvg
eSportsDolo (ROB) vs. Crabby (Dark Pit) - SSB4 Losers Quarters - SC46	Video:w2XDRwyC-ho	Channel:UC_dkX2_MJZeiYZImFN8AOvg
MVG|Ryo vs. RoguePenguin - SSB4 Winners Finals - SC46	Video:ldeyzmzh5do	Channel:UC_dkX2_MJZeiYZImFN8AOvg
Hala (Marth & Ike) vs. CrazieCuban (Toon Link) - SSB4 Losers R6 - SC46	Video:-tYmxHjb0PM	Channel:UC_dkX2_MJZeiYZImFN8AOvg
Hala (Marth & Ike) vs. Sensei (Mario) - SSB4 Losers R5 - SC46	Video:PDaStAMF_t4	Channel:UC_dkX2_MJZeiYZImFN8AOvg
MVG|Ryo (Doctor Mario & Roy) vs. Crabby (Dark Pit) - SSB4 Winners Semis - SC46	Video:akiqQoJh8o4	Channel:UC_dkX2_MJZeiYZImFN8AOvg
Oni Day (ZSS) vs. RoguePenguin (Mario) - SSB4 Winners Semis - SC46	Video:Q2YkJPGHQ0k	Channel:UC_dkX2_MJZeiYZImFN8AOvg
Jabe (Olimar) vs. Bobertingu (Little Mac & Jigglypuff) - SSB4 Losers R4 - SC46	Video:AnLKoFqz0t0	Channel:UC_dkX2_MJZeiYZImFN8AOvg
CrazieCuban (Toon Link) vs. RoguePenguin (Mario) - SSB4 Winners R4 - SC46	Video:FVjMxFzwtyw	Channel:UC_dkX2_MJZeiYZImFN8AOvg
YEEE (Rosalina) vs. MVG|Ryo (Zelda & C.Falcon) - SSB4 Winners R4 - SC46	Video:_Jtl16M8dyY	Channel:UC_dkX2_MJZeiYZImFN8AOvg
Crabby (Dark Pit) vs. ArcticFox (Fox) - SSB4 Winners R4 - SC46	Video:YZ41uk1le_s	Channel:UC_dkX2_MJZeiYZImFN8AOvg
Hala (Marth) vs. MVG|Ryo (C. Falcon & Link) - SSB4 Winners R3 - SC46	Video:1IOjwr_StMo	Channel:UC_dkX2_MJZeiYZImFN8AOvg
SuperSnarflePuff (Duck Hunt) vs. CrazieCuban (Toon Link) - SSB4 Winners R3 - SC46	Video:tLVR2Oq90Dk	Channel:UC_dkX2_MJZeiYZImFN8AOvg
eSportsDolo (ROB) vs. Cadence (Rosalina) - SSB4 Winners R3 - SC46	Video:Pu8FBLVJ28k	Channel:UC_dkX2_MJZeiYZImFN8AOvg
Tayne (Peach) vs. Crabby (Dark Pit) - SSB4 Winners R3 - SC46	Video:vexKqlZy-pE	Channel:UC_dkX2_MJZeiYZImFN8AOvg
Jabe (Olimar) vs. ArcticFox (Fox) - SSB4 Winners R3 - SC46	Video:ojvnVio9vbs	Channel:UC_dkX2_MJZeiYZImFN8AOvg
CrazieCuban (Toon Link & Jigglypuff) vs. DewDaDash (Diddy & Sheik) - SSB4 Grand Finals - SC45	Video:4hGY5Xy1RuA	Channel:UC_dkX2_MJZeiYZImFN8AOvg
ArcticFox (Fox) vs. DewDaDash (Diddy) - SSB4 Losers Finals - SC45	Video:cE1q9H-OMSg	Channel:UC_dkX2_MJZeiYZImFN8AOvg
Jeck (Yoshi) vs. DewDaDash (Diddy) - SSB4 Losers Semis - SC45	Video:Uo1q6OancKc	Channel:UC_dkX2_MJZeiYZImFN8AOvg
Saj (Palutena & Marth) vs. DewDaDash (Diddy) - SSB4 Losers Quarters - SC45	Video:6E6Okgzcm2w	Channel:UC_dkX2_MJZeiYZImFN8AOvg
Rupour (Ness) vs. Jeck (Yoshi) - SSB4 Losers Quarters - SC45	Video:d8OkUshC2ZY	Channel:UC_dkX2_MJZeiYZImFN8AOvg
Rupour (Ness) vs. eSportsDolo (Diddy) - SSB4 Losers R8 - SC45	Video:LoTNPTNdXPk	Channel:UC_dkX2_MJZeiYZImFN8AOvg
ArcticFox (Fox) vs. CrazieCuban (Toon Link) - SSB4 Winners Finals - SC45	Video:resamOW9v78	Channel:UC_dkX2_MJZeiYZImFN8AOvg
Saj (ZSS) vs. CrazieCuban (Toon Link) - SSB4 Winners Semis - SC45	Video:CGzefKqKBEI	Channel:UC_dkX2_MJZeiYZImFN8AOvg
Jeck (Yoshi) vs. ArcticFox (Fox) -SSB4 Winners Semis - SC45	Video:aPbkQ1k2nbM	Channel:UC_dkX2_MJZeiYZImFN8AOvg
eSportsDolo (Diddy & C. Falcon) vs. CrazieCuban (Toon Link) - SSB4 Winners R5 - SC45	Video:h4ajw29WbwA	Channel:UC_dkX2_MJZeiYZImFN8AOvg
ArcticFox (Fox) vs. Hala (Marth) - SSB4 Winners R4 - SC45	Video:jRucpZ8VGs4	Channel:UC_dkX2_MJZeiYZImFN8AOvg
CrazieCuban (Toon Link) vs. RoguePenguin (Mario) - SSB4 Winners R4 - SC45	Video:76fnaeUU-2o	Channel:UC_dkX2_MJZeiYZImFN8AOvg
Saj (Rosalina) vs. BlueBeast (Pit & Dark Pit) - SSB4 Winners R4 - SC45	Video:Spx3aLLMH8I	Channel:UC_dkX2_MJZeiYZImFN8AOvg
Jeck (Yoshi) vs. 7 (Meta Knight & Link) - SSB4 Winners R4 - SC45	Video:gKyocDctY2s	Channel:UC_dkX2_MJZeiYZImFN8AOvg
ArcticFox (Fox) vs. Flac0 (Rosalina) - SSB4 Winners R2 - SC45	Video:ykkWP-Lzqug	Channel:UC_dkX2_MJZeiYZImFN8AOvg
Rufio (Rosalina) vs. Hala (Marth) - SSB4 Winners R2 - SC45	Video:qoP1Km81Nic	Channel:UC_dkX2_MJZeiYZImFN8AOvg
Gustavo (Kirby) vs. Rupour (Ness) - SSB4 Winners R2 - SC45	Video:hS2K_W5YNPE	Channel:UC_dkX2_MJZeiYZImFN8AOvg
eSportsDolo & Hi-Hatz vs. Rupour & DewDaDash - SSB4 Teams Grand Finals - SC45	Video:maxl1n78QdI	Channel:UC_dkX2_MJZeiYZImFN8AOvg
eSportsDolo & Hi-Hatz vs. CrazieCuban & ArcticFox - SSB4 Teams Losers Finals - SC45	Video:Ad5Q35CP3SU	Channel:UC_dkX2_MJZeiYZImFN8AOvg
Jabe & Saj vs. CrazieCuban & ArcticFox - SSB4 Teams Losers Semis - SC45	Video:hVVtfwGb0ag	Channel:UC_dkX2_MJZeiYZImFN8AOvg
eSportsDolo & Hi-Hatz vs. Rupour & DewDaDash - SSB4 Teams Winners Finals - SC45	Video:pdOwoYL61d0	Channel:UC_dkX2_MJZeiYZImFN8AOvg
eSportsDolo & Hi-Hatz vs. CrazieCuban & ArcticFox - SSB4 Teams Winners Semis - SC45	Video:NMbd-CNEnBg	Channel:UC_dkX2_MJZeiYZImFN8AOvg
DewDaDash & Rupour vs. Tayn & Boan - SSB4 Teams Winners Semis - SC45	Video:MSziKG-czYU	Channel:UC_dkX2_MJZeiYZImFN8AOvg
Hi-Hatz & eSportsDolo vs. 7 & ROB - SSB4 Teams Winners R3 - SC45	Video:i7oenlCyFSk	Channel:UC_dkX2_MJZeiYZImFN8AOvg
Saj vs. MVG|Ryo (Samus, Mac, Lucina, Ganon, Falcon, Ike) - SSB4 Grand Finals - SC44	Video:znmT9F9JsLo	Channel:UC_dkX2_MJZeiYZImFN8AOvg
Saj (Peach) vs. Depth (Samus) - SSB4 Losers Finals - SC44	Video:kf8pwjyDGi4	Channel:UC_dkX2_MJZeiYZImFN8AOvg
Saj (Peach) vs. MVG|Sol (Little Mac) - SSB4 Losers Semis - SC44	Video:Cy-AEFmdGdA	Channel:UC_dkX2_MJZeiYZImFN8AOvg
Jeck (Yoshi) vs. MVG|Sol (Little Mac) - SSB4 Losers R9 - SC44	Video:m2GVx1hO3lU	Channel:UC_dkX2_MJZeiYZImFN8AOvg
BB|YLD (Olimar) vs. MVG|Sol (Little Mac) - SSB4 Losers R8 - SC44	Video:4cU_4JN7SFY	Channel:UC_dkX2_MJZeiYZImFN8AOvg
RYO'S FALCON PUNCH DESTRUCTION	Video:RAoPMqbcUT4	Channel:UC_dkX2_MJZeiYZImFN8AOvg
Depth (Samus) vs. MVG|Ryo (C. Falcon & Ike) - SSB4 Winners Finals - SC44	Video:oDH0TuI3cV0	Channel:UC_dkX2_MJZeiYZImFN8AOvg
BB|YLD (Olimar) vs. MVG|Ryo (Ike) - SSB4 Winners R5 - SC44	Video:Z5hB58yOvXo	Channel:UC_dkX2_MJZeiYZImFN8AOvg
CrazieCuban (Toon Link & Jigglypuff) vs. MVG|Ryo (Captain Falcon) - SSB4 Winners Semis - SC43	Video:LhzVR8Kkivw	Channel:UC_dkX2_MJZeiYZImFN8AOvg
Jeck (Yoshi) vs. Depth (Samus) - SSB4 Winners Semis - SC44	Video:60kUXxHkFXM	Channel:UC_dkX2_MJZeiYZImFN8AOvg
Depth (Samus) vs. Saj (Peach) - SSB4 Winners R5 - SC44	Video:dFKypJkzZEc	Channel:UC_dkX2_MJZeiYZImFN8AOvg
MVG|Ryo (Ike & Little Mac) vs. Son (Lucas & Charizard) - SSB4 Winners R4 - SC44	Video:tSakxRbVhAY	Channel:UC_dkX2_MJZeiYZImFN8AOvg
Jeck (Yoshi) vs. Zae26 (Rosalina) - SSB4 Winners R4 - SC44	Video:IBlEhL5CQbs	Channel:UC_dkX2_MJZeiYZImFN8AOvg
Quiksilver (Luigi) vs. MVG|Sol (Little Mac) - SSB4 Winners R3 - SC44	Video:t-3BhSE2UI0	Channel:UC_dkX2_MJZeiYZImFN8AOvg
GX2 (Fox) vs. Afmbot (Donkey Kong) - SSB4 Winners R3 - SC44	Video:9KuLfGKxOF4	Channel:UC_dkX2_MJZeiYZImFN8AOvg
Brand (ROB) vs. Depth (Samus) - SSB4 Winners R3 - SC44	Video:83S1vUTp3lU	Channel:UC_dkX2_MJZeiYZImFN8AOvg
MVG|Ryo & MVG|Sol vs. Rupour & Day - SSB4 Teams Grand Finals - SC44	Video:PQkMvxYSm6g	Channel:UC_dkX2_MJZeiYZImFN8AOvg
MVG|Ryo & MVG|Sol vs. Jag & Jeck - SSB4 Teams Losers Finals - SC44	Video:G1vHkuqgMIQ	Channel:UC_dkX2_MJZeiYZImFN8AOvg
MVG|Ryo & MVG|Sol vs. Zae26 & Juvey - SSB4 Teams Losers Semis - SC44	Video:3ocFiNoXeHA	Channel:UC_dkX2_MJZeiYZImFN8AOvg
MVG|Ryo & MVG|Sol vs. Hi-Hatz & eSportsDolo - SSB4 Teams Losers Quarters - SC44	Video:gcOgptVII0I	Channel:UC_dkX2_MJZeiYZImFN8AOvg
ArcticFox & CrazyCuban vs. Hi-Hatz & eSportsDolo - SSB4 Teams Losers R5 - SC44	Video:cQzwjwMVZuw	Channel:UC_dkX2_MJZeiYZImFN8AOvg
Jag & Jeck vs. Rupour & Day - SSB4 Teams Winners Finals - SC44	Video:t8sZ1wpBC8U	Channel:UC_dkX2_MJZeiYZImFN8AOvg
Jurvey & Zae26 vs. Rupour & Day - SSB4 Teams Winners Semis - SC44	Video:B80B4whsHkU	Channel:UC_dkX2_MJZeiYZImFN8AOvg
MVG|Ryo & MVG|Sol vs. Jag & Jeck - SSB4 Teams Winners Quarters - SC44	Video:XsaruX6oe58	Channel:UC_dkX2_MJZeiYZImFN8AOvg
Masta Puma (Fox) vs. Zae26 (Kirby) - SSB4 Grand Finals - SC43	Video:kbe9rhJ2opY	Channel:UC_dkX2_MJZeiYZImFN8AOvg
Crazie Cuban (Toon Link & Jigglypuff) vs. Zae26 (Rosalina) - SSB4 Losers Finals - SC43	Video:9-HfGG4lLrU	Channel:UC_dkX2_MJZeiYZImFN8AOvg
RoguePenguin (Mario) vs. Zae26 (Rosalina) - SSB4 Losers Semis- SC43	Video:lQiVb_tCnIA	Channel:UC_dkX2_MJZeiYZImFN8AOvg
RoguePenguin (Mario) vs. Saj (Palutena & Marth) - SSB4 Losers R9 - SC43	Video:XkY-NojsIRY	Channel:UC_dkX2_MJZeiYZImFN8AOvg
RoguePenguin (Mario) vs. MVG|Sol (Little Mac) - SSB4 Losers R8 - SC43	Video:8uq1gxiUTK8	Channel:UC_dkX2_MJZeiYZImFN8AOvg
Hi-Hatz (Ganon & G&W) vs. MVG|Sol (Little Mac) - SSB4 Losers R7 - SC43	Video:fXt3QkDq-lU	Channel:UC_dkX2_MJZeiYZImFN8AOvg
Masta Puma (Zero Suit & Mario) vs. Crazie Cuban (Toon Link & Jigglypuff) - SSB4 Winners Finals	Video:K3to8zV_r8w	Channel:UC_dkX2_MJZeiYZImFN8AOvg
RoguePenguin (Luigi) vs. Juvey (Mario) - SSB4 Losers R7 - SC43	Video:W4g7Rqjl6hA	Channel:UC_dkX2_MJZeiYZImFN8AOvg
Masta Puma (Rosalina & Zero Suit) vs. Zae26 (Rosalina & Kirby) - SSB4 Winners R6 - SC43	Video:8UEQniZsATM	Channel:UC_dkX2_MJZeiYZImFN8AOvg
Crazie Cuban (Toon Link & Jigglypuff) vs. Saj (Sheik) - SSB4 Winners R6 - SC43	Video:uECkNa11vSI	Channel:UC_dkX2_MJZeiYZImFN8AOvg
RoguePenguin (Mario) vs. Masta Puma (Rosalina) - SSB4 Winners R5 - SC43	Video:21BKCvquIzw	Channel:UC_dkX2_MJZeiYZImFN8AOvg
RoguePenguin (Mario) vs. Sensei (Mario) - SSB4 Winners R5 - SC43	Video:WOQx0kIm1xI	Channel:UC_dkX2_MJZeiYZImFN8AOvg
Rupour (Ness) vs. Crazie Cuban (Toon Link) - SSB4 Winners R5 - SC43	Video:D7ojNCI5kqI	Channel:UC_dkX2_MJZeiYZImFN8AOvg
Saj (Sheik) vs. Arctic Fox (Fox) - SSB4 Winners R4 - SC43	Video:8G5lSg1CTws	Channel:UC_dkX2_MJZeiYZImFN8AOvg
Puma (Fox) vs. Jag (Wario) - SSB4 Winners R4 - SC43	Video:JwaG0WJSQI8	Channel:UC_dkX2_MJZeiYZImFN8AOvg
Riot (Donkey Kong) vs. Crazie Cuban (Toon Link + Jigglypuff) - SSB4 Winners R4 - SC43	Video:G9W2wGVGxa0	Channel:UC_dkX2_MJZeiYZImFN8AOvg
HG Jabe (Olimar) vs. MVG|Sol (Little Mac) - SSB4 Winners R4 - SC43	Video:qV0n_jhMN_s	Channel:UC_dkX2_MJZeiYZImFN8AOvg
Cadence (Rosalina) vs. Riot (Donkey Kong) - SSB4 Winners Bracket - SC43	Video:W1sxAxlfAeY	Channel:UC_dkX2_MJZeiYZImFN8AOvg
Fax Machine & Rupour vs. Jurvey & Zae26 - SSB4 Teams Grand Finals - SC43	Video:AYlJpgCYd1Q	Channel:UC_dkX2_MJZeiYZImFN8AOvg
Fax Machine & Rupour vs. Migz & Riot - SSB4 Teams Losers Finals - SC43	Video:bzYuiNQgHk0	Channel:UC_dkX2_MJZeiYZImFN8AOvg
CrazyCuban & Arctic Fox vs. Rupour & Fax Machine - SSB4 Teams Losers Semis - SC43	Video:p9Ii2fZMfD8	Channel:UC_dkX2_MJZeiYZImFN8AOvg
Hi-Hatz & MVG|Sol vs. Rupour & Fax Machine - SSB4 Teams Losers Quarters - SC43	Video:OmaeO70ReEg	Channel:UC_dkX2_MJZeiYZImFN8AOvg
RoguePenguin & SnarkyFox vs. CrazyCuban & Arctic Fox - SSB4 Teams Losers R6 - SC43	Video:xRoxlUxo7K0	Channel:UC_dkX2_MJZeiYZImFN8AOvg
Crabby & Saj vs. Rupour & Fax Machine - SSB4 Teams Losers R5 - SC43	Video:pZ_LDmqLKWk	Channel:UC_dkX2_MJZeiYZImFN8AOvg
Migz & Riot vs. Zae26 & Juvey - SSB4 Teams Winners Finals - SC43	Video:3w6cZ1Ii1uM	Channel:UC_dkX2_MJZeiYZImFN8AOvg
MVG|Sol & Hi-Hatz vs. Zae26 & Jurvey - SSB4 Teams Winners Semis - SC43	Video:h29oIdVfizI	Channel:UC_dkX2_MJZeiYZImFN8AOvg
MVG|Sol & Hi-Hatz vs. Crazy Cuban & Arctic Fox - SSB4 Teams Winners R3 - SC43	Video:ZDrq1snyiuE	Channel:UC_dkX2_MJZeiYZImFN8AOvg
COG MVG|Mew2King (Fox) vs. SS|Colbol (Fox & Marth) - Melee Grand Finals - Smash 'til Dawn	Video:9GrARXH_b58	Channel:UC_dkX2_MJZeiYZImFN8AOvg
COG|Wizzrobe (C. Falcon) vs. SS|Colbol (Marth & Fox) - Melee Losers Finals - Smash 'til Dawn	Video:61y9TwGSTZM	Channel:UC_dkX2_MJZeiYZImFN8AOvg
COG|Wizzrobe (C. Falcon) vs. Linguini (Ganon) - Melee Losers Semis - Smash 'til Dawn	Video:1IbZdv1Bew0	Channel:UC_dkX2_MJZeiYZImFN8AOvg
COG MVG|Mew2King (Sheik & Marth) vs. SS|Colbol (Fox) - Melee Winners Finals - Smash 'til Dawn	Video:Oa47rJTG610	Channel:UC_dkX2_MJZeiYZImFN8AOvg
COG|Wizzrobe (C. Falcon) vs. Rula (Falco) - Melee Top 8 - Smash 'til Dawn	Video:lcigmt7dmfs	Channel:UC_dkX2_MJZeiYZImFN8AOvg
Uuaa (Fox) vs. Linguini (Ganon) - Melee Top 8 - Smash 'til Dawn	Video:NDVKBUQXlso	Channel:UC_dkX2_MJZeiYZImFN8AOvg
SS|Colbol (Marth) vs. Rula (Falco) - Melee Winners Semis - Smash 'til Dawn	Video:QsvFn0ukQIQ	Channel:UC_dkX2_MJZeiYZImFN8AOvg
COG MVG|Mew2King (Sheik) vs. Linguini (Ganon) - Melee Winners Semis - Smash 'til Dawn	Video:aBtXRW0wPzE	Channel:UC_dkX2_MJZeiYZImFN8AOvg
MVG|Ryo (Ike) vs. 8-BitMan (ROB) - SSB4 Grand Finals - Smash 'til Dawn	Video:pwB1DtdssJs	Channel:UC_dkX2_MJZeiYZImFN8AOvg
MVG|Ryo (Ike) vs. ONI StaticManny (Roy) - SSB4 Losers Finals - Smash 'til Dawn	Video:eRrK53DmRfI	Channel:UC_dkX2_MJZeiYZImFN8AOvg
COG MVG|M2K (Mario, Meta Knight, & Donkey) vs. StaticManny (Sonic) - SSB4 Losers Semis	Video:0syyVFNOInQ	Channel:UC_dkX2_MJZeiYZImFN8AOvg
COG MVG|Mew2King (Mario & Donkey Kong) vs. COG|Wizzrobe (Sheik) - SSB4 Losers Quarters	Video:Li1k-MQAkiE	Channel:UC_dkX2_MJZeiYZImFN8AOvg
MVG|Ryo (Ike) vs. 8-BitMan (ROB) - SSB4 Winners Finals - Smash 'til Dawn	Video:GtZ9xLlfR4Q	Channel:UC_dkX2_MJZeiYZImFN8AOvg
ONI StaticManny (Sonic) vs. Ed (Sheik) - SSB4 Top 8 - Smash 'til Dawn	Video:v-rWM-ObgmE	Channel:UC_dkX2_MJZeiYZImFN8AOvg
Poltergust (Yoshi) vs. Ed (Sheik) - SSB4 Top 16 - Smash 'til Dawn	Video:D0njRNUp4s0	Channel:UC_dkX2_MJZeiYZImFN8AOvg
COG|Wizzrobe (Sheik) vs. Myran (Olimar) - SSB4 Top 16 - Smash 'til Dawn	Video:1DqhQHWNI4E	Channel:UC_dkX2_MJZeiYZImFN8AOvg
Ed (Sheik) vs. EE|JaZz (Fox) - SSB4 Top 16 - Smash 'til Dawn	Video:6DCh_GmgzRg	Channel:UC_dkX2_MJZeiYZImFN8AOvg
MVG|Sol (Little Mac) vs. Myran (Olimar) - SSB4 Top 16 - Smash 'til Dawn	Video:70_9n37tWow	Channel:UC_dkX2_MJZeiYZImFN8AOvg
FreshDieNasty (Sheik) vs. COG|Wizzrobe (Sheik) - SSB4 Top 16 -Smash 'til Dawn	Video:DCGPq3ucjWA	Channel:UC_dkX2_MJZeiYZImFN8AOvg
VGR DMG|Ross (Toon Link) vs. COG|Wizzrobe (Sheik) - SSB4 Top 16 - Smash 'til Dawn	Video:5moyTfRFSDU	Channel:UC_dkX2_MJZeiYZImFN8AOvg
COG MVG|Mew2King (Meta Knight & Donkey Kong) vs. 8-BitMan (ROB) - Smash 'til Dawn SSB4 Top 16	Video:8JiZ_jaXLC0	Channel:UC_dkX2_MJZeiYZImFN8AOvg
MVG|Ryo (Ike) vs. ONI StaticManny (Sonic & Roy) - SSB4 Top 8 - Smash 'til Dawn	Video:L2Iq3wz49cw	Channel:UC_dkX2_MJZeiYZImFN8AOvg
MVG|Ryo (Ike) vs. FreshDieNasty (Sheik) - SSB4 Top 16 - Smash 'til Dawn	Video:d4LcdRYsLno	Channel:UC_dkX2_MJZeiYZImFN8AOvg
Ed (Sheik) vs. VK (Sonic) - SSB4 Pools - Smash 'til Dawn	Video:MizSuKRaw2Y	Channel:UC_dkX2_MJZeiYZImFN8AOvg
Depth (Samus) vs. KidG (Mario) - SSB4 Pools - Smash 'til Dawn	Video:F-8QCSa98H0	Channel:UC_dkX2_MJZeiYZImFN8AOvg
Dyr (Diddy) vs. FreshDieNasty (Sheik) - SSB4 Pools - Smash 'til Dawn	Video:Da6JOrT0AJM	Channel:UC_dkX2_MJZeiYZImFN8AOvg
MVG|Ryo (Ike) vs. Ed (Sheik) - SSB4 Pools - Smash 'til Dawn	Video:2B-8BBHA1oA	Channel:UC_dkX2_MJZeiYZImFN8AOvg
Dyr (Diddy) vs. CreamSoda (Roy & Shulk) - SSB4 Pools - Smash 'til Dawn	Video:CkPg1XzMQG8	Channel:UC_dkX2_MJZeiYZImFN8AOvg
KidG (Mario) vs. Ed (Sheik) - SSB4 Pools - Smash 'til Dawn	Video:mDjJ6rctC7s	Channel:UC_dkX2_MJZeiYZImFN8AOvg
MVG|Ryo (Ike) vs. Sleepy (Link) - SSB4 Pools - Smash 'til Dawn	Video:opIWPMQgesA	Channel:UC_dkX2_MJZeiYZImFN8AOvg
Tachyon (Pikachu) vs. Jeremy (Mario) - SSB4 Pools - Smash 'til Dawn	Video:K57SYKv3sFs	Channel:UC_dkX2_MJZeiYZImFN8AOvg
MVG|Sol (Little Mac) vs. Streetshark (Sonic) - SSB4 Pools - Smash 'til Dawn	Video:Dz-9xc-J_dc	Channel:UC_dkX2_MJZeiYZImFN8AOvg
Prodigy (Diddy) vs. Jeremy (Mario) - SSB4 Pools - Smash 'til Dawn	Video:Z70EWjGVG6Y	Channel:UC_dkX2_MJZeiYZImFN8AOvg
SSHQ GDX (Diddy) vs. COG|Wizzrobe (Sheik) - SSB4 Pools - Smash 'til Dawn	Video:uGMJXkTPt5Y	Channel:UC_dkX2_MJZeiYZImFN8AOvg
Poltergust (Luigi) vs. Tachyon (Pikachu) - SSB4 Pools - Smash 'til Dawn	Video:C5QNQl9NqNs	Channel:UC_dkX2_MJZeiYZImFN8AOvg
8-Bitman (ROB) vs. Streetshark (Sonic) - SSB4 Pools - Smash 'til Dawn	Video:7IFQVB2vWEc	Channel:UC_dkX2_MJZeiYZImFN8AOvg
Prodigy (Diddy) vs. Streetshark (Sonic) - SSB4 Pools - Smash 'til Dawn	Video:fxE2sgtbtRU	Channel:UC_dkX2_MJZeiYZImFN8AOvg
Prodigy (Diddy) vs. Vook (Donkey Kong & Mario) - SSB4 Pools - Smash 'til Dawn	Video:eACmcx7lMew	Channel:UC_dkX2_MJZeiYZImFN8AOvg
D. Barker (Diddy) vs, Streetshark (Sonix & Ryu) - SSB4 Pools - Smash 'til Dawn	Video:mDqCHDXCtoU	Channel:UC_dkX2_MJZeiYZImFN8AOvg
MVG|Sol (Little Mac) vs. Tony (Ness & Samus) - SSB4 Pools - Smash 'til Dawn	Video:G66a2xthHS4	Channel:UC_dkX2_MJZeiYZImFN8AOvg
Dyr Interview at Smash Conference 42	Video:MdQEoeYoL4Q	Channel:UC_dkX2_MJZeiYZImFN8AOvg
Mew2King Interview at Smash Conference 42	Video:gD9jaonul4E	Channel:UC_dkX2_MJZeiYZImFN8AOvg
Dyr (Diddy) vs. COG MVG|Mew2King (Donkey Kong) - SSB4 Grand Finals - SC42	Video:oUXMKCxt3dA	Channel:UC_dkX2_MJZeiYZImFN8AOvg
Dyr (Diddy) vs. MVG|Sol (Little Mac) - SSB4 Losers Finals - Smash Conference 42	Video:deEkMNlz23c	Channel:UC_dkX2_MJZeiYZImFN8AOvg
Zae26 (Kirby & Rosalina) vs. MVG|Sol (Little Mac) - SSB4 Losers Semis - SC42	Video:YQG9yEI-OqI	Channel:UC_dkX2_MJZeiYZImFN8AOvg
ONI|Day (Lucario) vs. MVG|Sol (Little Mac) - SSB4 Losers R9 - Smash Conference 42	Video:YSr-z1ry0XE	Channel:UC_dkX2_MJZeiYZImFN8AOvg
Zae26 (Rosalina) vs. O Rocket (Diddy) - SSB4 Losers R9 - Smash Conference 42	Video:JH_sqigddmc	Channel:UC_dkX2_MJZeiYZImFN8AOvg
ONI|Day (Lucario) vs. MVG|Ryo (Ike) - SSB4 Losers Semis - Smash Conference 42	Video:5h9dMK5JWs4	Channel:UC_dkX2_MJZeiYZImFN8AOvg
COG MVG| Mew2King (Mario & Donkey Kong) vs. Dyr (Diddy) - SSB4 Winners Finals - SC42	Video:Bv7LPvx1-0I	Channel:UC_dkX2_MJZeiYZImFN8AOvg
COG MVG|M2K (Meta Knight & Donkey) vs. MVG|Sol (Little Mac) - SSB4 Winners Semis - SC42	Video:5-ezfprXV5M	Channel:UC_dkX2_MJZeiYZImFN8AOvg
Dyr (Diddy) vs. Zae26 (Rosalina + G&W) - SSB4 Winners Semis - Smash Conference 42	Video:2lMhBWR2YoU	Channel:UC_dkX2_MJZeiYZImFN8AOvg
Depth (Samus) vs. COG MVG|Mew2King (Donkey Kong) - SSB4 Winners R5 - Smash Conference 42	Video:sIlBk4LQCgU	Channel:UC_dkX2_MJZeiYZImFN8AOvg
RoguePenguin (Mario) vs. MVG|Sol (Little Mac) - SSB4 Winners R5 - Smash Conference 42	Video:oHpV9YBx_-U	Channel:UC_dkX2_MJZeiYZImFN8AOvg
Saj (Peach) vs. Zae26 (Rosalina) - SSB4 Winners R5 - Smash Conference 42	Video:t-KVCmZ8mQQ	Channel:UC_dkX2_MJZeiYZImFN8AOvg
MVG|Ryo (Ike) vs. Dyr (Diddy) - SSB4 Winners R4 - Smash Conference R4	Video:F6Lghbw1IOA	Channel:UC_dkX2_MJZeiYZImFN8AOvg
YEEE (Rosalina) vs. Depth (Samus) - SSB4 Winners R4 - Smash Conference 42	Video:eH2dJXECbnU	Channel:UC_dkX2_MJZeiYZImFN8AOvg
Tayne (Peach) vs. MVG|Sol (Little Mac) - SSB4 Winners R4 - Smash Conference 42	Video:tTKcenRb8X8	Channel:UC_dkX2_MJZeiYZImFN8AOvg
Zae26 (Kirby & Rosalina) vs. Hala (Marth) - SSB4 Winners R3 - Smash Conference 42	Video:4G3-V66bgeo	Channel:UC_dkX2_MJZeiYZImFN8AOvg
Dyr (Diddy) vs. Crabby (Dark Pit) - SSB4 Winners R3 - Smash Conference 42	Video:N8Nv2oLjp3Y	Channel:UC_dkX2_MJZeiYZImFN8AOvg
GX2 (Ryu) vs. Hi-Hatz (Ganondorf) - SSB4 Winners R3 - Smash Conference 42	Video:f1UZfzfNt5Y	Channel:UC_dkX2_MJZeiYZImFN8AOvg
Ryo and Sol Eat a Ghost Chili Pepper!	Video:_Q7xtaLNRGA	Channel:UC_dkX2_MJZeiYZImFN8AOvg
MVG|Ryo (Little Mac, Palutena, & Ike) vs. Saj (Peach) - Grand Finals	Video:qbAO3XgBNnI	Channel:UC_dkX2_MJZeiYZImFN8AOvg
ONI|Day (Lucario) vs. Saj (Peach) - SSB4 Losers Finals - Smash Conference 41	Video:iDHF5VEsRu8	Channel:UC_dkX2_MJZeiYZImFN8AOvg
Saj (Peach) vs. eSportsDolo (Luigi) - SSB4 Winners Semis - Smash Conference 41	Video:HEXCh1jSiPs	Channel:UC_dkX2_MJZeiYZImFN8AOvg
Saj (Peach) vs. MVG|Sol (Little Mac) - SSB4 Losers Quarters - Smash Conference 41	Video:fA95Qd7Cvl4	Channel:UC_dkX2_MJZeiYZImFN8AOvg
ONI|Day (Lucario) vs. MVG|Ryo (Ike & Samus) - SSB4 Winners Finals - Smash Conference 41	Video:HEdKOtYZfzI	Channel:UC_dkX2_MJZeiYZImFN8AOvg
ONI|Day (Lucario) vs. Saj (Peach) - SSB4 Winners Semis - Smash Conference 41	Video:GolJio4T94Q	Channel:UC_dkX2_MJZeiYZImFN8AOvg
Depth (Samus) vs. MVG|Ryo (Ike) - SSB4 Winners Semis - Smash Conference 41	Video:ckXfLEB4coU	Channel:UC_dkX2_MJZeiYZImFN8AOvg
Sensei (Mario) vs, MVG|Ryo (Ike) - SSB4 Winners Quarters - Smash Conference 41	Video:vilH65oT9aQ	Channel:UC_dkX2_MJZeiYZImFN8AOvg
Jabe (Olimar) vs. MVG|Sol (Little Mac) - SSB4 Winners R4 - Smash Conference 41	Video:TqmMAB9Dr2Y	Channel:UC_dkX2_MJZeiYZImFN8AOvg
O Rocket (Diddy) vs. Hala (Marth) - SSB4 Winners R4 - Smash Conference 41	Video:rU-jer9tNXc	Channel:UC_dkX2_MJZeiYZImFN8AOvg
Depth (Samus) vs. Rupour (Ness) - SSB4 Winners R4 - Smash Conference 41	Video:etLmH_lh6Tg	Channel:UC_dkX2_MJZeiYZImFN8AOvg
Saj (Peach) vs. WHG ROB (Captain Falcon) - SSB4 Winners R3 - Smash Conference 41	Video:xiUfZspMphE	Channel:UC_dkX2_MJZeiYZImFN8AOvg
Brand (ROB) vs. eSportsDolo (Luigi) - SSB4 Winners R3 - Smash Conference 41	Video:TKT4jjSu3Po	Channel:UC_dkX2_MJZeiYZImFN8AOvg
Sensei (Mario) vs. MVG|Dadex (Sheik) - SSB4 Winners R3 - Smash Conference 41	Video:jTtdQRlV1uE	Channel:UC_dkX2_MJZeiYZImFN8AOvg
Crabby (Dark Pit) vs. Hala (Marth) - SSB4 Winners R3 - Smash Conference 41	Video:EMvNX5AAhuY	Channel:UC_dkX2_MJZeiYZImFN8AOvg
ONI|Day (Lucario) vs. Cadence (Rosalina) - SSB4 Winners R3 - Smash Conference 41	Video:SUKl2a9oDi0	Channel:UC_dkX2_MJZeiYZImFN8AOvg
Hyliann (Link) vs. MVG|Ryo (Ike & Zelda) - SSB4 Winners R2 - Smash Conference 41	Video:C1EHycizsUk	Channel:UC_dkX2_MJZeiYZImFN8AOvg
Saj & Hiroi vs. MVG|Sol & MVG|Ryo - Teams SSB4 Grand Finals - Smash Conference 41	Video:o-pyK_zFlgc	Channel:UC_dkX2_MJZeiYZImFN8AOvg
Saj & Hiroi vs. Hi-Hatz & eSportsDolo - Teams SSB4 Losers Finals - Smash Conference 41	Video:kg8SxpbxG9w	Channel:UC_dkX2_MJZeiYZImFN8AOvg
ONI|Day & Arctic Fox vs. Hi-Hatz & eSportsDolo - Teams SSB4 Losers Semis - Smash Conference 41	Video:MQUyu77OU34	Channel:UC_dkX2_MJZeiYZImFN8AOvg
Saj & Hiroi vs. MVG|Sol & MVG|Ryo - Teams SSB4 Winners Finals - Smash Conference 41	Video:3LotPLW2PTI	Channel:UC_dkX2_MJZeiYZImFN8AOvg
Jag & Jeck vs. MVG|Sol & MVG|Ryo - Teams SSB4 Winners Semis - Smash Conference 41	Video:Jky7ZdEgQFA	Channel:UC_dkX2_MJZeiYZImFN8AOvg
ONI|Day & Arctic Fox vs. Saj & Hiroi - Teams SSB4 Winners Semis - Smash Conference 41	Video:phWDFxdlVE0	Channel:UC_dkX2_MJZeiYZImFN8AOvg
Depth & Tumltus vs. Jag & Jeck - Teams SSB4 Winners Quarters - Smash Conference 41	Video:1RvWytffKyM	Channel:UC_dkX2_MJZeiYZImFN8AOvg
Hi-Hatz & eSportsDolo vs. Saj Hiroi - Teams SSB4 Winners Quarters - Smash Conference 41	Video:B_96dsR3vtk	Channel:UC_dkX2_MJZeiYZImFN8AOvg
Outlaw Pika & JimK vs. MVG|Ryo & MVG|Sol - Teams SSB4 Winners R2 - Smash Conference 41	Video:8UyHicJIHjs	Channel:UC_dkX2_MJZeiYZImFN8AOvg
SJMaxG & Vatra vs. Jabe & Gxfire - Teams SSB4 Winners R1 - Smash Conference 41	Video:tCMnqyhDlrM	Channel:UC_dkX2_MJZeiYZImFN8AOvg
Mew2King Destroys ONI|Day - 4 EASY STOCKS - Smash Wii U	Video:LQPQDOChDFw	Channel:UC_dkX2_MJZeiYZImFN8AOvg
Mew2King 4 Stocks Westballz at Paragon LA!	Video:h9DC701d0ww	Channel:UC_dkX2_MJZeiYZImFN8AOvg
MVG|Ryo & MVG|Sol vs. ONI|Day & COG MVG M2K - Teams SSB4 Winners Finals - CFL Smackdown	Video:UHEqb1HsemU	Channel:UC_dkX2_MJZeiYZImFN8AOvg
Poltergust & Streetshark vs. MVG|Sol & MVG|Ryo - Teams SSB4 Losers Finals - CFL Smackdown	Video:OwG6mMG3fQo	Channel:UC_dkX2_MJZeiYZImFN8AOvg
COG MVG|M2K & ONI|Day vs. MVG|Sol & MVG|Ryo - Teams SSB4 Grand Finals - CFL Smackdown	Video:dWvETLWJUKk	Channel:UC_dkX2_MJZeiYZImFN8AOvg
Hiroi & Noa vs. Day & COG MVG|Mew2King - Teams SSB4 Winners Semis - CFL Smackdown	Video:yHJdy3ZIaoo	Channel:UC_dkX2_MJZeiYZImFN8AOvg
Poltergust & Streetshark vs. MVG|Sol & MVG|Ryo - Teams SSB4 Winners Semis - CFL Smackdown	Video:RoPGii2A2jc	Channel:UC_dkX2_MJZeiYZImFN8AOvg
Poltergust & Streetshark vs. Saj & Jabe - Teams SSB4 Losers Semis - CFL Smackdown	Video:j6h4AeHgq4o	Channel:UC_dkX2_MJZeiYZImFN8AOvg
Poltergust (Yoshi) vs. COG MVG|Mew2King (Donkey Kong & Rosalina) - SSB4 Losers Finals -	Video:INC12d1KwYQ	Channel:UC_dkX2_MJZeiYZImFN8AOvg
Poltergust (Luigi & Yoshi) vs. MVG|Ryo (Ike & Palutena) - SSB4 Grand Finals - CFL Smackdown	Video:FqWgQWzB4B4	Channel:UC_dkX2_MJZeiYZImFN8AOvg
Poltergust (Luigi) vs. Saj (Peach) - SSB4 Losers Semis - CFL Smackdown	Video:kMMMqlIRM5Q	Channel:UC_dkX2_MJZeiYZImFN8AOvg
Noa (Ness) vs. Saj (Peach) - SSB4 Losers Top 8 - CFL Smackdown	Video:eFzAP2eoxy4	Channel:UC_dkX2_MJZeiYZImFN8AOvg
Poltergust (Yoshi) vs. Riot (Donkey Kong) - SSB4 Losers Top 8 - CFL Smackdown	Video:SaidLvDUfOM	Channel:UC_dkX2_MJZeiYZImFN8AOvg
MVG|Ryo (Ike) vs. COG MVG|Mew2king (Donkey Kong & Mario) - SSB4 Winners Finals	Video:sNY_vomSLdI	Channel:UC_dkX2_MJZeiYZImFN8AOvg
COG MVG|Mew2King (Donkey Kong) vs. Riot (Donkey Kong) - SSB4 Winners Semis	Video:-In_oxBWc7Y	Channel:UC_dkX2_MJZeiYZImFN8AOvg
MVG|Ryo (Ike) vs. Noa (Ness) - SSB4 Winners Semis - CFL Smackdown	Video:YgSGH0AwBPU	Channel:UC_dkX2_MJZeiYZImFN8AOvg
Riot (Donkey Kong) vs. ONI|Day (Zero Suit) - SSB4 Top 8 - CFL Smackdown	Video:hb5BaEe2KUs	Channel:UC_dkX2_MJZeiYZImFN8AOvg
MVG|Sol (Little Mac) vs. COG|Wizzrobe (Sheik) - SSB4 Top 16 - CFL Smackdown	Video:4Z88-33jHGw	Channel:UC_dkX2_MJZeiYZImFN8AOvg
GX2 (Ryu) vs. Poltergust (Yoshi) - SSB4 Losers Top 16 - CFL Smackdown	Video:Hrvn5MSFLLw	Channel:UC_dkX2_MJZeiYZImFN8AOvg
XMG (Wii Fit) vs. Jabe (Olimar) - SSB4 Pools - CFL Smackdown	Video:7dAtHP-1m5A	Channel:UC_dkX2_MJZeiYZImFN8AOvg
Sun (Lucas) vs. Riot (Donkey Kong) - SSB4 Pools - CFL Smackdown	Video:9aa6v_JeVbs	Channel:UC_dkX2_MJZeiYZImFN8AOvg
Poltergust (Yoshi & Luigi) vs. O Rocket (Diddy) - SSB4 Winners -CFL Smackdown	Video:BUSDAJvK_ss	Channel:UC_dkX2_MJZeiYZImFN8AOvg
ONI|Day (Lucario) vs. Co18 (King Dedede) - SSB4 Winners - CFL Smackdown	Video:au_Fb_XUBw0	Channel:UC_dkX2_MJZeiYZImFN8AOvg
Saj (Peach) vs. Riot (Donkey Kong) - SSB4 Winners - CFL Smackdown	Video:eCr7dlzEw2A	Channel:UC_dkX2_MJZeiYZImFN8AOvg
MVG|Ryo (Ike) vs. GX2 (Fox) - SSB4 Winners - CFL Smackdown	Video:CUYcwKt1zsU	Channel:UC_dkX2_MJZeiYZImFN8AOvg
StreetShark (Sonic) vs. COG|Wizzrobe (Sheik) - SSB4 Winners - CFL Smackdown	Video:iwB9X88I3as	Channel:UC_dkX2_MJZeiYZImFN8AOvg
Noa (Ness) vs. Sensei (Mario) - SSB4 Winners - CFL Smackdown	Video:-mN8BpfAKHU	Channel:UC_dkX2_MJZeiYZImFN8AOvg
MVG|Ryo (Ike) vs. GoTE|Minstorn (Little Mac) - SSB4 Winners - CFL Smackdown	Video:32y6pCUdMyA	Channel:UC_dkX2_MJZeiYZImFN8AOvg
Jojo (Bowser & Charizard) vs. ONI|Day (Lucario) - SSB4 Winners - CFL Smackdown	Video:shJ9RkW5Qg4	Channel:UC_dkX2_MJZeiYZImFN8AOvg
MVG|Ryo vs. COG MVG|Mew2King - Friendly Set	Video:Tw2KZee1oZ4	Channel:UC_dkX2_MJZeiYZImFN8AOvg
Mew2King Interview and Answers Viewer's Questions!	Video:zIiy8dgKvd8	Channel:UC_dkX2_MJZeiYZImFN8AOvg
ONI|Day vs. COG MVG|Mew2King - Friendly Set	Video:cs7azbg4MAw	Channel:UC_dkX2_MJZeiYZImFN8AOvg
ONI|Day (Zero Suit) vs. COG MVG|Mew2King (Mario & Donkey Kong) - SSB4 Grand Finals	Video:7_z1cKg7syw	Channel:UC_dkX2_MJZeiYZImFN8AOvg
ONI|Day (Lucario) vs. MVG|Ryo (Ike & Palutena) - SSB4 Losers Finals - Smash Conference 40	Video:MWnmIcCGgDM	Channel:UC_dkX2_MJZeiYZImFN8AOvg
ONI|Day (Lucario) vs. MVG|Sol (Little Mac) - SSB4 Losers Semis - Smash Conference 40	Video:JAil_ovYWSk	Channel:UC_dkX2_MJZeiYZImFN8AOvg
Depth (Samus) vs. MVG|Sol (Little Mac) - SSB4 Losers Quarters - Smash Conference 40	Video:KagXT3Nbp9c	Channel:UC_dkX2_MJZeiYZImFN8AOvg
DewDaDash (Sheik) vs. ONI|Day (Lucario) - SSB4 Losers Quarters - Smash Conference 40	Video:tHTlqbpA30M	Channel:UC_dkX2_MJZeiYZImFN8AOvg
Depth (Samus) vs. Rupour (Ness) - SSB4 Losers R8 - Smash Conference 40	Video:cSptfdchICg	Channel:UC_dkX2_MJZeiYZImFN8AOvg
ONI|Day (Lucario & Zero Suit) vs. COG MVG|Mew2King (Donkey Kong) - SSB4 Winners Semis	Video:jMoFXpUocY4	Channel:UC_dkX2_MJZeiYZImFN8AOvg
COG MVG|Mew2King (Donkey Kong & Mario) vs. MVG|Ryo (Ike) - SSB4 Winners Finals - Smash Conference 40	Video:2VHykf6HquQ	Channel:UC_dkX2_MJZeiYZImFN8AOvg
MVG|Sol (Little Mac) vs. MVG|Ryo (Ike & Captain Falcon) - SSB4 Winners Semis - Smash Conference 40	Video:-i52_N5gjSA	Channel:UC_dkX2_MJZeiYZImFN8AOvg
Juvey (Luigi) vs. MVG|Ryo (Ike & Palutena) - SSB4 Winners R5 - Smash Conference 40	Video:Yd2NTHGwUxE	Channel:UC_dkX2_MJZeiYZImFN8AOvg
GX2 (Fox) vs. COG MVG|Mew2King (Donkey Kong) - SSB4 Winners R5 - Smash Conference 40	Video:nMuMAK_AJ_4	Channel:UC_dkX2_MJZeiYZImFN8AOvg
YLD (Olimar) vs. MVG|Sol (Little Mac) - SSB4 Winners R4 - Smash Conference 40	Video:nneHtyMuUIY	Channel:UC_dkX2_MJZeiYZImFN8AOvg
Jabe (Olimar) & ONI|Day (Lucario) - SSB4 Winners R4 - Smash Conference 40	Video:oPInTVIFu4w	Channel:UC_dkX2_MJZeiYZImFN8AOvg
Juvey (Luigi) vs. O Rocket (Diddy Kong) - SSB4 Winners R4 - Smash Conference 40	Video:3D07pHwJDTA	Channel:UC_dkX2_MJZeiYZImFN8AOvg
Lupo (Zero Suit & Palutena) vs. MVG|Ryo (Ike & Palutena) - SSB4 Winners R2 - Smash Conference 40	Video:n7savWkTV8U	Channel:UC_dkX2_MJZeiYZImFN8AOvg
ONI|Day & Rupour vs. MVG|Ryo & MVG|Sol - Teams SSB4 Grand Finals - Smash Conference 40	Video:bCuNI5xVKgA	Channel:UC_dkX2_MJZeiYZImFN8AOvg
YLD & Depth vs. MVG|Ryo & MVG|Sol - Teams SSB4 Losers Finals - Smash Conference 40	Video:JcdgZOYlIhc	Channel:UC_dkX2_MJZeiYZImFN8AOvg
YLD & Depth vs. Hiroi & Saj - Teams SSB4 Losers Semis - Smash Conference 40	Video:z3DkbwqZiAE	Channel:UC_dkX2_MJZeiYZImFN8AOvg
ONI|Day & Rupour vs. MVG|Ryo & MVG|Sol - Teams SSB4 Winners Finals - Smash Conference 40	Video:EfHo03wvIhs	Channel:UC_dkX2_MJZeiYZImFN8AOvg
Mew2King Reacts to GRSmash: Top 10 lol m2k moments #2	Video:gl_6iI81bUs	Channel:UC_dkX2_MJZeiYZImFN8AOvg
Mew2King does an EYES CLOSED REST! (Drunk M2K)	Video:F0lUxW6_gHg	Channel:UC_dkX2_MJZeiYZImFN8AOvg
MVG|Ryo (Ike) vs. Angel Noa (Ness) - SSB4 Grand Finals - Smash Conference 39	Video:ckuFDntjDnk	Channel:UC_dkX2_MJZeiYZImFN8AOvg
MVG|Ryo (Ike & Palutena) vs. ONI|Phuzix (Sheik) - SSB4 Losers Finals - Smash Conference 39	Video:1YYK_WZGhKo	Channel:UC_dkX2_MJZeiYZImFN8AOvg
MVG|Ryo (Ike & Palutena) vs. Angel Noa (Ness) - SSB4 Winners Finals - Smash Conference 39	Video:T0vnuyih-6E	Channel:UC_dkX2_MJZeiYZImFN8AOvg
ONI|Phuzix (Sheik) vs. Saj (Peach) - SSB4 Losers Semis - Smash Conference 39	Video:fXqKLVymhnQ	Channel:UC_dkX2_MJZeiYZImFN8AOvg
ONI|Phuzix (Sheik) vs. GoTE|Prodigy (Diddy) - SSB4 Losers Quarters - Smash Conference 39	Video:zWU60Dh7MKc	Channel:UC_dkX2_MJZeiYZImFN8AOvg
MVG|Sol (Little Mac) vs. Saj (Peach) - SSB4 Losers Quarters - Smash Conference 39	Video:tCt31IHiH5U	Channel:UC_dkX2_MJZeiYZImFN8AOvg
ONI|Phuzix (Sheik) vs. Riot (Donkey Kong) - SSB4 Losers R8 - Smash Conference 39	Video:lwkFgr9Y0Gs	Channel:UC_dkX2_MJZeiYZImFN8AOvg
MVG|Sol (Little Mac) vs. DewDaDash (Diddy) - SSB4 Losers R8 - Smash Conference 39	Video:2edENBDiaZg	Channel:UC_dkX2_MJZeiYZImFN8AOvg
GX2 (Ryu) vs. ONI|Phuzix (Sheik) - SSB4 Losers R7 - Smash Conference 39	Video:QqSW5WCbIeA	Channel:UC_dkX2_MJZeiYZImFN8AOvg
Saj (Peach) vs. Angel Noa (Ness) - SSB4 Winners Semis - Smash Conference 39	Video:FnFTmWZKkh0	Channel:UC_dkX2_MJZeiYZImFN8AOvg
MVG|Ryo (Ike) vs. GoTE|Prodigy (Diddy) - SSB4 Winners R5 - Smash Conference 39	Video:DMvLDDN0NaQ	Channel:UC_dkX2_MJZeiYZImFN8AOvg
ONI|Phuzix (Sheik) vs. Angel Noa (Ness) - SSB4 Winners R5 - Smash Conference 39	Video:UVGrp5ZRv1k	Channel:UC_dkX2_MJZeiYZImFN8AOvg
GoTE|Prodigy (Diddy) vs. MVG|Sol (Little Mac) - SSB4 Winners R5 - Smash Conference 39	Video:yUEGICMDNQY	Channel:UC_dkX2_MJZeiYZImFN8AOvg
MVG|Ryo (Palutena) vs. DewDaDash (Diddy & Sheik) - SSB4 Winners R5 - Smash Conference 39	Video:9ZN5yfnYiNI	Channel:UC_dkX2_MJZeiYZImFN8AOvg
Saj (Peach) vs. Riot (Donkey Kong) - SSB4 Winners R5 - Smash Conference 39	Video:FiyiirAYHfo	Channel:UC_dkX2_MJZeiYZImFN8AOvg
Phuzix (Sheik) vs. Fax Machine (Kirby) - SSB4 Winners R4 - Smash Conference 39	Video:GOw7CveDseo	Channel:UC_dkX2_MJZeiYZImFN8AOvg
GX2 (Ryu) vs. DewDaDash (Sheik) - SSB4 Winners R4 - Smash Conference 39	Video:acGRg_QvBWw	Channel:UC_dkX2_MJZeiYZImFN8AOvg
eSportsDolo (Luigi) vs. Riot (Donkey Kong) - SSB4 Winners R4 - Smash Conference 39	Video:-Xz8l0NkGr4	Channel:UC_dkX2_MJZeiYZImFN8AOvg
MVG|Ryo (Link & Little Mac) vs. ROB (Captain Falon) - SSB4 Winners R4 - Smash Conference 39	Video:Nv8ZGYBjw5c	Channel:UC_dkX2_MJZeiYZImFN8AOvg
Fr1zz (Yoshi) vs. MVG|Sol (Little Mac) - SSB4 Winners R3 - Smash Conference 39	Video:INZAxKgLoVA	Channel:UC_dkX2_MJZeiYZImFN8AOvg
Riot (Donkey Kong) vs. Rogue Penguin (Mario) - SSB4 Winners R3 - Smash Conference 39	Video:Nmk3l3g-Y9M	Channel:UC_dkX2_MJZeiYZImFN8AOvg
Saj (Peach) vs. Minty (Mario) - SSB4 Winners R2 - Smash Conference 39	Video:wxLLe489-Rg	Channel:UC_dkX2_MJZeiYZImFN8AOvg
Rupour (Ness) vs. Nasuma (Zero Suit) - SSB4 Winners R2 - Smash Conference 39	Video:HOhmzCiAy3Y	Channel:UC_dkX2_MJZeiYZImFN8AOvg
Bringo (Palutena & Lucas) vs. MVG|Ryo (Palutena & Lucina) - SSB4 Winners R2 - Smash Conference 39	Video:IWfR7T9QVWQ	Channel:UC_dkX2_MJZeiYZImFN8AOvg
Angel Noa & Riot vs. MVG|Ryo & MVG|Sol - Teams SSB4 Grand Finals - Smash Conference 39	Video:uz2ClOrx0Yw	Channel:UC_dkX2_MJZeiYZImFN8AOvg
Angel Noa & Riot vs. ROB & 7 - Teams SSB4 Losers Finals - Smash Conference 39	Video:oZqjZ-Obd0Q	Channel:UC_dkX2_MJZeiYZImFN8AOvg
Angel Noa & Riot vs. Rupour & Fax Machine - Teams SSB4 Losers Semis - Smash Conference 39	Video:HVvYoTWdgIc	Channel:UC_dkX2_MJZeiYZImFN8AOvg
RoguePenguin & SnarkyFox vs. Rupour & Fax Machine - Teams SSB4 Losers Quarters - Smash Conference 39	Video:urqxb-vrm_s	Channel:UC_dkX2_MJZeiYZImFN8AOvg
MVG|Ryo & MVG|Sol vs. ROB & 7 - Teams SSB4 Winners Finals - Smash Conference 39	Video:nleez1z__1I	Channel:UC_dkX2_MJZeiYZImFN8AOvg
Fax Machine & Rupour vs. ROB & 7 - Teams SSB4 Winners Semis - Smash Conference 39	Video:gwh5NV2Cwe0	Channel:UC_dkX2_MJZeiYZImFN8AOvg
Rogue Penguin & Snarky Fox vs. Hiroi & Angel Noa - Teams SSB4 Winners R2 - Smash Conference 39	Video:bO2YWzurbtA	Channel:UC_dkX2_MJZeiYZImFN8AOvg
MVG|Ryo & MVG|Sol vs. SwagBinoba & Oil Prices - Teams SSB4 Winners R2 - Smash Conference 39	Video:Ss-JB22WM_Y	Channel:UC_dkX2_MJZeiYZImFN8AOvg
HCG Hurricane & Jag vs. Jabe & Gxfire - Teams SSB4 Winners R2 - Smash Conference 39	Video:8qbKr507lac	Channel:UC_dkX2_MJZeiYZImFN8AOvg
MVG|DadeX and MVG|Ryo Outro Rap	Video:lN3Qw6KURjg	Channel:UC_dkX2_MJZeiYZImFN8AOvg
Mew2King 3 STOCKS Medz with Pichu!	Video:LYpfdpuIHzI	Channel:UC_dkX2_MJZeiYZImFN8AOvg
ONI|Phuzix (Sheik) vs. MVG|Ryo (Palutena & Ike) - SSB4 Grand Finals - Smash Conference 38	Video:uG5UQpKVRfo	Channel:UC_dkX2_MJZeiYZImFN8AOvg
ONI|Phuzix (Sheik) vs. MVG|Ryo (Zelda, Lucina, & Ike) - SSB4 Winners Finals - Smash Conference 38	Video:a2hQCmDEvyA	Channel:UC_dkX2_MJZeiYZImFN8AOvg
O Rocket (Diddy) vs. Rupour (Ness) - SSB4 Losers Semis - Smash Conference 38	Video:tKmAqtmd2qo	Channel:UC_dkX2_MJZeiYZImFN8AOvg
O Rocket (Diddy) vs. VGR DMG|Ross (Sheik & Ike) - SSB4 Losers Quarters - Smash Conference 38	Video:0phAwj4JsCY	Channel:UC_dkX2_MJZeiYZImFN8AOvg
Tachyon (Pikachu) vs. Rupour (Ness) - SSB4 Losers R8 - Smash Conference 38	Video:MVf4WC3bJZQ	Channel:UC_dkX2_MJZeiYZImFN8AOvg
O Rocket (Diddy) vs. MVG|Sol (Little Mac) - SSB4 Losers R8 - Smash Conference 38	Video:4q3xYhQJTgY	Channel:UC_dkX2_MJZeiYZImFN8AOvg
MVG|Ryo (Lucina & Ike) vs. VGR DMG|Ross (Sheik) - SSB4 Winners Semis - Smash Conference 38	Video:B9FOoYMaTxI	Channel:UC_dkX2_MJZeiYZImFN8AOvg
ONI|Phuzix (Sheik) vs. Rupour (Ness) - SSB4 Winners Semis - Smash Conference 38	Video:kB_wFeybf7s	Channel:UC_dkX2_MJZeiYZImFN8AOvg
Tachyon (Pikachu) vs. VGR DMG|Ross (Sheik) - SSB4 Winners Semis - Smash Conference 38	Video:pJc-pdBPGhs	Channel:UC_dkX2_MJZeiYZImFN8AOvg
Degree of Fear (Zero Suit) vs. MVG|Ryo (Ike) - SSB4 Winners R5 - Smash Conference 38	Video:Hg-SOQ5N4ow	Channel:UC_dkX2_MJZeiYZImFN8AOvg
ONI|Phuzix (Sheik) vs. MVG|Sol (Little Mac) - SSB4 Winners R5 - Smash Conference 38	Video:JIRG0T1NTO8	Channel:UC_dkX2_MJZeiYZImFN8AOvg
GX2 (Ryu) vs. HCG|Hurricane (Jigglypuff) - SSB4 Losers R4 - Smash Conference 38	Video:aF8SN9u_OUY	Channel:UC_dkX2_MJZeiYZImFN8AOvg
MVG|Sol (Little Mac) vs. Jeck (Yoshi) - SSB4 Winners R4 - Smash Conference 38	Video:ynpX0gOaBgc	Channel:UC_dkX2_MJZeiYZImFN8AOvg
MVG|Ryo (Ike & Lucina) vs. DewDaDash (Sheik & Diddy) - SSB4 Winners R4 - Smash Conference 38	Video:9dtUbmwrj3g	Channel:UC_dkX2_MJZeiYZImFN8AOvg
Vaan (Captain Falcon) vs. ONI|Day (Lucario & Zero Suit) - SSB4 Winners R3 - Smash Conference 38	Video:PK4XW51KruI	Channel:UC_dkX2_MJZeiYZImFN8AOvg
MVG|Sol (Little Mac) vs. Volc (Yoshi) - SSB4 Winners R3 - Smash Conference 38	Video:13SquhoBLzw	Channel:UC_dkX2_MJZeiYZImFN8AOvg
MVG|Ryo (Ike) vs. CC742 (Rob) - SSB4 Winners R2 - Smash Conference 38	Video:_QhONKDJL08	Channel:UC_dkX2_MJZeiYZImFN8AOvg
VGR DMG|Ross & ONI|Day vs. MVG|Ryo & MVG|Ryo - Teams SSB4 Grand Finals - Smash Conference 38	Video:nxEFs3Zpx30	Channel:UC_dkX2_MJZeiYZImFN8AOvg
Tachyon & Volc vs. MVG|Ryo & MVG|Sol - Teams SSB4 Losers Finals - Smash Conference 38	Video:SdreF1OQlQk	Channel:UC_dkX2_MJZeiYZImFN8AOvg
Tachyon & Volc vs. Jabe & Saj - Teams SSB4 Losers Semis - Smash Conference 38	Video:FRi3PfzFTeM	Channel:UC_dkX2_MJZeiYZImFN8AOvg
VGR DMG|Ross & ONI|Day vs. MVG|Ryo & MVG|Sol - Teams SSB4 Winners Finals - Smash Conference 38	Video:uNMA_93z0D0	Channel:UC_dkX2_MJZeiYZImFN8AOvg
Afmbot & VGR|Fil vs. Jabe & Saj - Teams SSB4 Losers R5 - Smash Conference 38	Video:JGYNsgQcBxI	Channel:UC_dkX2_MJZeiYZImFN8AOvg
VGR DMG|Ross & ONI|Day vs. Jag & Jeck - Teams SSB4 Winners Semis - Smash Conference 38	Video:nre8MExzN3Q	Channel:UC_dkX2_MJZeiYZImFN8AOvg
Tachyon & Volc vs. Fax Machine & Rupour - Teams SSB4 Losers R4 - Smash Conference 38	Video:bPQ9fTIan_E	Channel:UC_dkX2_MJZeiYZImFN8AOvg
MVG|Ryo & MVG|Sol vs. Quiksilver & Vann - Teams SSB4 Winners R4 - Smash Conference 38	Video:qC1DIBMvsEI	Channel:UC_dkX2_MJZeiYZImFN8AOvg
Jabe & Saj vs. Jag & Jeck - Teams SSB4 Winners R3 - Smash Conference 38	Video:Ojrh_J7MG3k	Channel:UC_dkX2_MJZeiYZImFN8AOvg
Hi-Hatz & MVG|Dadex vs. GX2 & GxFire - Teams SSB4 Winners R2 - Smash Conference 38	Video:W6ImW2Zp1Mw	Channel:UC_dkX2_MJZeiYZImFN8AOvg
ROB & 7 vs. MVG|Sol & MVG|Ryo - Teams SSB4 Winners R3 - Smash Conference 38	Video:s5LLzeRhY3U	Channel:UC_dkX2_MJZeiYZImFN8AOvg
Afmbot & VGR|Fil vs.HCG|Hurricane & C_rez - Teams SSB4 Losers R1 - Smash Conference 38	Video:89ZmqI5ouyM	Channel:UC_dkX2_MJZeiYZImFN8AOvg
OPmetaknight1 & Jahpna vs. MVG|Ryo & MVG|Sol - Teams SSB4 Winners R1 - Smash Conference 38	Video:oZ4YOF2CWJI	Channel:UC_dkX2_MJZeiYZImFN8AOvg
eSportsDolo & Crabby vs. Quiksilver & Vann - Teams SSB4 Winners R1 - Smash Conference 38	Video:epPwPCo_j64	Channel:UC_dkX2_MJZeiYZImFN8AOvg
Ultimate Falcon Punch Combo - Mew2King - Super Smash Bros. Melee	Video:dcTA0FwtBNw	Channel:UC_dkX2_MJZeiYZImFN8AOvg
Mew2King Interview at Smash Conference 37	Video:0qGoJ2VNHhc	Channel:UC_dkX2_MJZeiYZImFN8AOvg
COG MVG|Mew2King vs. MVG|Ryo - SSB4 Grand Finals - Smash Conference 37	Video:ymXFoCmITgQ	Channel:UC_dkX2_MJZeiYZImFN8AOvg
Saj (Peach) vs. COG MVG|Mew2King (Donkey Kong) - SSB4 Losers Semis - Smash Conference 37	Video:ymwu9G9PF3M	Channel:UC_dkX2_MJZeiYZImFN8AOvg
Saj (Peach) vs. MVG|Sol (Little Mac) - SSB4 Losers Quarters - Smash Conference 37	Video:as2I4XGVQrM	Channel:UC_dkX2_MJZeiYZImFN8AOvg
Saj (Peach) vs. DewDaDash (Diddy Kong) - SSB4 Losers R8 - Smash Conference 37	Video:1C7Dy9_4T7Y	Channel:UC_dkX2_MJZeiYZImFN8AOvg
Saj (Peach) vs. Ducky (Little Mac) - SSB4 Losers R7- Smash Conference 37	Video:b-K6bEMUN_I	Channel:UC_dkX2_MJZeiYZImFN8AOvg
Tachyon (Pikachu) vs. Afmbot (Donkey Kong) - SSB4 Losers R7 - Smash Conference 37	Video:haeisbRW0Ys	Channel:UC_dkX2_MJZeiYZImFN8AOvg
Rupour (Ness) vs. ROB (Mario) - SSB4 Losers R6 - Smash Conference 37	Video:3o36QQJPY1U	Channel:UC_dkX2_MJZeiYZImFN8AOvg
Jeck (Yoshi) vs. DewDaDash (Diddy Kong) - SSB4 Losers R6 - Smash Conference 37	Video:EmOyJ2-L0XU	Channel:UC_dkX2_MJZeiYZImFN8AOvg
COG MVG|Mew2King (Charizard) vs. ONI|Day (Lucario) - SSB4 Winners Semis - Smash Conference 37	Video:SnmdN9TmeBs	Channel:UC_dkX2_MJZeiYZImFN8AOvg
MVG|Sol (Little Mac) vs. MVG|Ryo (Ike) - SSB4 Winners Semis - Smash Conference 37	Video:z-YPXkfPIho	Channel:UC_dkX2_MJZeiYZImFN8AOvg
Saj (Peach) vs. ONI|Day (Lucario) - SSB4 Winners R5 - Smash Conference 37	Video:dpqoJ8Xu3F8	Channel:UC_dkX2_MJZeiYZImFN8AOvg
MVG|Ryo (Ike) vs. Riot (Donkey Kong) - SSB4 Winners R4 - Smash Conference 37	Video:0SyraDwn9b8	Channel:UC_dkX2_MJZeiYZImFN8AOvg
Saj (Peach) vs. Afmbot (Donkey Kong) - SSB4 Winners R4 - Smash Conference 37	Video:Ffso-EeO1n4	Channel:UC_dkX2_MJZeiYZImFN8AOvg
GX2 (Ryu) vs. COG MVG|Mew2King (Mario) - SSB4 Winners R4 - Smash Conference 37	Video:qypj4XVVtAQ	Channel:UC_dkX2_MJZeiYZImFN8AOvg
Ducky (Little Mac) vs. MVG|Sol (Little Mac) - SSB4 Winners R4 - Smash Conference 37	Video:AnbbZuEdQDU	Channel:UC_dkX2_MJZeiYZImFN8AOvg
Quiksilver (Luigi) vs. Jabe (Olimar) - SSB4 Winners R2 - Smash Conference 37	Video:2Y_XAO33EeA	Channel:UC_dkX2_MJZeiYZImFN8AOvg
BowserKingB (Bowser) vs. MVG|Ryo (Ike & Captain Falcon) - SSB4 Winners R2 - Smash Conference 37	Video:WzP0vu2f7cY	Channel:UC_dkX2_MJZeiYZImFN8AOvg
GX2 (Fox & Ryu) vs. Crabby (Dark Pit) - SSB4 Winners R3 - Smash Conference 37	Video:KGOXz90HBZk	Channel:UC_dkX2_MJZeiYZImFN8AOvg
GumbyChef (Captain Falcon) vs. MVG|Sol (Little Mac) - SSB4 Winners R2 - Smash Conference 37	Video:Bzu4ipLFmy8	Channel:UC_dkX2_MJZeiYZImFN8AOvg
ONI|Day & COG MVG|Mew2King vs. MVG|Sol & MVG|Ryo - Teams SSB4 Grand Finals - Smash Conference 37	Video:wtwTbncWCFw	Channel:UC_dkX2_MJZeiYZImFN8AOvg
Rupour & Vesarus vs. MVG|Sol & MVG|Ryo - Teams SSB4 Losers Finals - Smash Conference 37	Video:GqFLXD0zKfc	Channel:UC_dkX2_MJZeiYZImFN8AOvg
ONI|Day & COG MVG|Mew2King vs. MVG|Sol & MVG|Ryo - Teams SSB4 Winners Finals - Smash Conference 37	Video:OFSQDQxZmRo	Channel:UC_dkX2_MJZeiYZImFN8AOvg
eSportsDolo & Crabby vs. Vesarus & Rupour - Teams SSB4 Losers Semis - Smash Conference 37	Video:kV0FFQy18LE	Channel:UC_dkX2_MJZeiYZImFN8AOvg
Saj & Hiroi vs. Vesarus & Rupour - Teams SSB4 Losers Quarters - Smash Conference 37	Video:877fPBItNbc	Channel:UC_dkX2_MJZeiYZImFN8AOvg
Saj & Hiroi vs. COG MVG| Mew2King & ONI|Day - Teams SSB4 Winners Semis - Smash Conference 37	Video:rUWopaJN3Lw	Channel:UC_dkX2_MJZeiYZImFN8AOvg
Jag & Jeck vs. MVG|Sol & MVG|Ryo - Teams SSB4 Winners Semis - Smash Conference 37	Video:RVtLW76zOyo	Channel:UC_dkX2_MJZeiYZImFN8AOvg
eSportsDolo & Crabby vs. COG MVG| Mew2King & ONI|Day - Teams SSB4 Winners R3 - Smash Conference 37	Video:MAi1mSOwQp8	Channel:UC_dkX2_MJZeiYZImFN8AOvg
Mew2King vs. Classic Mode - Master & Crazy Hand Highlights	Video:bEgFsVXvD3A	Channel:UC_dkX2_MJZeiYZImFN8AOvg
10 - 72% Donkey Kong Combo on Ike!	Video:6tS_Ch0xdJQ	Channel:UC_dkX2_MJZeiYZImFN8AOvg
Mew2King vs. Pilot Wings	Video:qmR-67qgPoc	Channel:UC_dkX2_MJZeiYZImFN8AOvg
Ryo Plays the Mind Games Against Mew2King!	Video:o1lCWl26YNk	Channel:UC_dkX2_MJZeiYZImFN8AOvg
Mew2King Event Mode on Hard Difficulty - Highlights	Video:k6naF3norio	Channel:UC_dkX2_MJZeiYZImFN8AOvg
Mew2King Amazing JV5!!!	Video:-ykEGgToY0w	Channel:UC_dkX2_MJZeiYZImFN8AOvg
STVG|Phuzix vs. VGR|Ross - Winners R4 - Smash Conference 36	Video:x39V4Q0V2iU	Channel:UC_dkX2_MJZeiYZImFN8AOvg
STVG|Phuzix vs. StaticManny - Winners Semis - Smash Conference 36	Video:ZovJ0Vgd4qE	Channel:UC_dkX2_MJZeiYZImFN8AOvg
BTvolta vs. Quicksilver - Losers R3 - Smash Conference 36	Video:p71lCUNkMIU	Channel:UC_dkX2_MJZeiYZImFN8AOvg
Tachyon vs. VGR|Ross - Losers Quarters - Smash Conference 36	Video:oXdSctLOXeU	Channel:UC_dkX2_MJZeiYZImFN8AOvg
Quicksilver vs.  Saj - Losers R4 - Smash Conference 36	Video:R8jhqIeuLG4	Channel:UC_dkX2_MJZeiYZImFN8AOvg
Rogue Penguin vs. Saj - Losers R5 - Smash Conference 36	Video:XcqP0OqdjOo	Channel:UC_dkX2_MJZeiYZImFN8AOvg
STVG|Phuzix vs  Saj - Losers Quarters - Smash Conference 36	Video:_0CBlpyUW0Y	Channel:UC_dkX2_MJZeiYZImFN8AOvg
Tachyon vs  Saj - Losers Semis - Smash Conference 36	Video:6Te7ZLhYd_k	Channel:UC_dkX2_MJZeiYZImFN8AOvg
Tachyon vs. Static Manny - Losers Finals - Smash Conference 36	Video:EsFm1YoXwq8	Channel:UC_dkX2_MJZeiYZImFN8AOvg
MVG|Ryo vs. Tachyon - Winners Semis -  Smash Conference 36	Video:OX-vc2rkl5Y	Channel:UC_dkX2_MJZeiYZImFN8AOvg
MVG|Ryo vs. Static Manny - Grand Finals - Smash Conference 36	Video:HLzK_tivw9Y	Channel:UC_dkX2_MJZeiYZImFN8AOvg
MVG|Ryo vs  Static Manny - Winners Finals - Smash Conference 36	Video:s3VkD5X4ejY	Channel:UC_dkX2_MJZeiYZImFN8AOvg
Mew2King vs Vex - Mii Brawler Ditto	Video:pNYyqzA1eoY	Channel:UC_dkX2_MJZeiYZImFN8AOvg
Mew2King Has a Falco?!	Video:RxxtbOuorFU	Channel:UC_dkX2_MJZeiYZImFN8AOvg
M2K just happens. Axe asks Tai for help.	Video:bgbYZz_pDXA	Channel:UC_dkX2_MJZeiYZImFN8AOvg
Mew2King 4 Stocks Axe!!!	Video:nzmTR0z3TQU	Channel:UC_dkX2_MJZeiYZImFN8AOvg
Day vs. MVG | Ryo - Grand Finals - SSB4 - Invictus Championship Series	Video:PHBZm_DAOm4	Channel:UC_dkX2_MJZeiYZImFN8AOvg
Day vs. MVG | Ryo - Grand Finals (Set 2) - SSB4 - Invictus Championship Series	Video:lrgSNJDC4co	Channel:UC_dkX2_MJZeiYZImFN8AOvg
VGR DMG | Ross vs. MVG | Ryo - Losers Finals - SSB4 - Invictus Championship Series	Video:uC_YtN9eoRk	Channel:UC_dkX2_MJZeiYZImFN8AOvg
VGR DMG | Ross vs. Chez - Losers Semis - SSB4 - Invictus Championship Series	Video:sYmHpLoKxGQ	Channel:UC_dkX2_MJZeiYZImFN8AOvg
Day vs. MVG | Ryo - Winners Finals - SSB4 - Invictus Championship Series	Video:oYvwzB1ZwLI	Channel:UC_dkX2_MJZeiYZImFN8AOvg
Day vs. Chez - Winners Semis - SSB4 - Invictus Championship Series	Video:gmZUNAys9tU	Channel:UC_dkX2_MJZeiYZImFN8AOvg
MVG | Ryo vs. Tachyon - Winners Semis - SSB4 - Invictus Championship Series	Video:ooHXBMMfsPU	Channel:UC_dkX2_MJZeiYZImFN8AOvg
MVG | Ryo vs. HOH Saj - Winners R4 - SSB4 - Invictus Championship Series	Video:tsLLJkkyMwI	Channel:UC_dkX2_MJZeiYZImFN8AOvg
Volc vs. EsportsDolo - Losers R5 - SSB4 - Invictus Championship Series	Video:nD7rsyIIMgk	Channel:UC_dkX2_MJZeiYZImFN8AOvg
Day vs. EsportsDolo - Winners R4 - SSB4 - Invictus Championship Series	Video:PdPw3wa6Lp4	Channel:UC_dkX2_MJZeiYZImFN8AOvg
Mew2King and Axe Swap Mains?	Video:V-WyF8qovLU	Channel:UC_dkX2_MJZeiYZImFN8AOvg
GAAM Gainesville Vs. Jacksonville Guys Crew Battle Smash4	Video:Jkd4B90QSlo	Channel:UC_dkX2_MJZeiYZImFN8AOvg
GAAM Gainesville Vs. Jacksonville Girls Crew Battle Smash4	Video:BuxlAXQIZ8c	Channel:UC_dkX2_MJZeiYZImFN8AOvg
Mew2King JV3 with Mii Brawler	Video:lyaMcod0f7k	Channel:UC_dkX2_MJZeiYZImFN8AOvg
Mew2King takes a Coffee Break Mid-Match vs. Axe	Video:4V2pVUTB-qY	Channel:UC_dkX2_MJZeiYZImFN8AOvg
Mew2King and Axe: The Stare Down	Video:34pm6cxzlJg	Channel:UC_dkX2_MJZeiYZImFN8AOvg
TLC LSG EightGrade vs. Chaos Jazdero - Smash Factor 4 - Winners Top 8 - USFIV	Video:Ni1QFhdzeMQ	Channel:UC_dkX2_MJZeiYZImFN8AOvg
TT Tako vs. Chaos Master - Smash Factor 4 - Losers Top 8 - USFIV	Video:Xf4-BP7uTdw	Channel:UC_dkX2_MJZeiYZImFN8AOvg
Shadow X vs. Raseroth - Smash Factor 4 - Losers Top 8 - USFIV	Video:QCzgZjkH6cI	Channel:UC_dkX2_MJZeiYZImFN8AOvg
Chaos Jazdero vs. TLC Gama - Smash Factor 4 - Winners Top 8 - USFIV	Video:wO0KjFHP21w	Channel:UC_dkX2_MJZeiYZImFN8AOvg
SF DS Shadow X vs. TLC LSG Eightgrade - Smash Factor 4 - Losers Top 8 - USFIV	Video:zVrDLT1KFWc	Channel:UC_dkX2_MJZeiYZImFN8AOvg
Chaos Jazdero vs.  TLC LSG Eightgrade - Smash Factor 4 - Losers Finals - USFIV	Video:QLTIu8ejU00	Channel:UC_dkX2_MJZeiYZImFN8AOvg
LSG Gama vs. TLC Raseroth - Smash Factor 4 - Winners Top 8 - USFIV	Video:3XRMnvwdU6g	Channel:UC_dkX2_MJZeiYZImFN8AOvg
SF DS Shadow X vs. TLC Gorito - Smash Factor 4 - Losers Top 8 - USFIV	Video:_eRblxf-ZxI	Channel:UC_dkX2_MJZeiYZImFN8AOvg
TLC LSG Eightgrade vs. Chaos Master - Smash Factor 4 - Losers Top 8 - USFIV	Video:hX2srAk-nxM	Channel:UC_dkX2_MJZeiYZImFN8AOvg
Chaos Jazdero vs. TLC Gama - Smash Factor 4 - Grand Finals - USFIV	Video:9ceR7AOQKnY	Channel:UC_dkX2_MJZeiYZImFN8AOvg
OF Bachiller vs. C4 Pony - Smash Factor 4 - Winners Top 8 - Marvel vs. Capcom	Video:KhrOJdXOI98	Channel:UC_dkX2_MJZeiYZImFN8AOvg
Apologyman vs. SF T3 Dizzy - Smash Factor 4 - Winners Top 8 - Marvel vs. Capcom	Video:0JzElVu5kbU	Channel:UC_dkX2_MJZeiYZImFN8AOvg
T3 Wolf vs. SF T3 Dizzy - Smash Factor 4 - Losers Top 8 - Marvel vs. Capcom	Video:C7DiM3NW_oE	Channel:UC_dkX2_MJZeiYZImFN8AOvg
OF Bachiller vs. SF T3 Dizzy - Smash Factor 4 - Losers Semis - Marvel vs. Capcom	Video:QigyYID_RYk	Channel:UC_dkX2_MJZeiYZImFN8AOvg
CF SF Pony vs. SF T3 Dizzy - Smash Factor 4 - Losers Finals - Marvel vs. Capcom	Video:gtVLGTJ5MYU	Channel:UC_dkX2_MJZeiYZImFN8AOvg
Apologyman vs. CF SF Pony - Smash Factor 4 - Grand Finals - Marvel vs. Capcom	Video:7HVCbSHm52c	Channel:UC_dkX2_MJZeiYZImFN8AOvg
MVG | Mew2king vs Valdo - Smash Factor 4 - Top 8 - SSBM	Video:DtzhGgBTjgU	Channel:UC_dkX2_MJZeiYZImFN8AOvg
A2A vs Valdo - Smash Factor 4 - Top 8 - SSBM	Video:JY_pmz41IkI	Channel:UC_dkX2_MJZeiYZImFN8AOvg
Hyuga vs. Hymura - Smash Factor 4 - Winners Quarters - Smash Wii U	Video:ZT5uD0UX2x0	Channel:UC_dkX2_MJZeiYZImFN8AOvg
Mr. R vs. Brawl CO|Wonf - Smash Factor 4 - Losers Quarters - Smash Wii U	Video:O-0nEJWKBtk	Channel:UC_dkX2_MJZeiYZImFN8AOvg
Waymas vs Hymura - Smash Factor 4 - Losers Quarters - Smash Wii U	Video:ZBht5ZwHUlE	Channel:UC_dkX2_MJZeiYZImFN8AOvg
Mr. R vs Waymas - Smash Factor 4 - Losers Semis - Smash Wii U	Video:eep82XxR9GM	Channel:UC_dkX2_MJZeiYZImFN8AOvg
MK Leo vs Hyuga - Smash Factor 4 - Winners Finals - Smash Wii U	Video:0y4M1-l2boA	Channel:UC_dkX2_MJZeiYZImFN8AOvg
Mr. R vs Hyuga - Smash Factor 4 - Losers Finals - Smash Wii U	Video:NLLmUjWrzkU	Channel:UC_dkX2_MJZeiYZImFN8AOvg
MK Leo vs Mr. R - Smash Factor 4 - Grand Finals -  Smash Wii U	Video:h4R0pXrC-dg	Channel:UC_dkX2_MJZeiYZImFN8AOvg
Valdo vs XTR | Medz - Smash Factor 4 - Losers Quarters	Video:flBan4nfJqw	Channel:UC_dkX2_MJZeiYZImFN8AOvg
MVG | Mew2King vs Tempo | Axe - Smash Factor 4 - Winners Finals	Video:4SG9s387kMQ	Channel:UC_dkX2_MJZeiYZImFN8AOvg
XTR | Medz vs. Tempo | Axe - Smash Factor 4 - Losers Finals	Video:7Eqb2_riCNo	Channel:UC_dkX2_MJZeiYZImFN8AOvg
MVG | Mew2King vs Tempo | Axe - Smash Factor 4 - Grand Finals (Part 2) - SSBM	Video:hAJ_yvntNSE	Channel:UC_dkX2_MJZeiYZImFN8AOvg
MVG | Mew2King vs Tempo | Axe - Smash Factor 4 - Grand Finals - SSBM	Video:kjLq18pBk_Y	Channel:UC_dkX2_MJZeiYZImFN8AOvg
M2K Gets a Few 4-Stocks on Tai	Video:UdfOfEOUtmE	Channel:UC_dkX2_MJZeiYZImFN8AOvg
M2K Nearly 4-stocks AXE	Video:fEois4VcBOI	Channel:UC_dkX2_MJZeiYZImFN8AOvg
SC35: Tachyon(Pikachu) Vs  TFS|SGJet(Shulk) Losers Round 5	Video:5zj_hg52peY	Channel:UC_dkX2_MJZeiYZImFN8AOvg
SC35: Tachyon(Pikachu) Vs STVG|Phuzix(Sheik) Losers Quarters	Video:OfLauQo8iJg	Channel:UC_dkX2_MJZeiYZImFN8AOvg
SC35: SSHQ|StreetShark(Sonic) Vs STVG|Phuzix(Sheik) Losers Semis	Video:0Rl4y9CwRZk	Channel:UC_dkX2_MJZeiYZImFN8AOvg
SC35: StaticManny(Sonic) Vs STVG|Phuzix(Sheik) Winners Semis	Video:hJUvtFOvV6s	Channel:UC_dkX2_MJZeiYZImFN8AOvg
SC35: Tachyon(Pikachu) Vs MVG|Sol(Lil Mac) Losers Round 6	Video:irUkAOvLP5A	Channel:UC_dkX2_MJZeiYZImFN8AOvg
SC35: StaticManny(Sonic+Roy) Vs MVG|Ryo(Ike+Roy) Grand Finals	Video:HhP-uXjadec	Channel:UC_dkX2_MJZeiYZImFN8AOvg
SC:35 Saj(Peach) Vs MVG|Ryo(Ike) Winners Quarters	Video:O4gqnK1GmMo	Channel:UC_dkX2_MJZeiYZImFN8AOvg
SC35: StaticManny(Sonic) Vs MVG|Ryo(Ike+Lucina) Winners Finals	Video:-P-N0tsZI7U	Channel:UC_dkX2_MJZeiYZImFN8AOvg
SC35: StaticManny(Sonic) Vs STVG|Phuzix(Sheik) Losers Finals	Video:VfT-_hrI3gM	Channel:UC_dkX2_MJZeiYZImFN8AOvg
SC35: EE|KDB(Yoshi) Vs SSHQ|StreetShark(Sonic) Losers Quarters	Video:jmtZTZ0zznA	Channel:UC_dkX2_MJZeiYZImFN8AOvg
SC35: RoguePenguin(Mario) Vs. MVG|Ryo(Palutena+Roy) Winners Round 4	Video:uuAzPRfNmBU	Channel:UC_dkX2_MJZeiYZImFN8AOvg
SC35: EE|KDB(Yoshi) Vs STVG|Phuzix(Sheik) Winners Quarters	Video:29y4n97aOCo	Channel:UC_dkX2_MJZeiYZImFN8AOvg
SC 35: MVG|Ryo(Ike) Vs. SSHQ|StreetShark(Sonic) Winners Semis	Video:OJoj0wdWJ34	Channel:UC_dkX2_MJZeiYZImFN8AOvg
Why I Love Charizard - Mew2King Super Smash Bros Wii U Montage	Video:qRnq1eFt2NY	Channel:UC_dkX2_MJZeiYZImFN8AOvg
MVG Ryo (Ike) vs SSHQ StreetShark (Sonic & Mario) - SSB4 Grand Finals Set 2 - Smash Wii U	Video:kSDX4roXwHI	Channel:UC_dkX2_MJZeiYZImFN8AOvg
MVG Ryo (Ike & Roy) vs SSHQ StreetShark (Sonic & Mario) SSB4 Grand Finals   Smash Wii U	Video:wuX581MGetY	Channel:UC_dkX2_MJZeiYZImFN8AOvg
MVG Ryo (Ike) vs Jeck 95 (Yoshi) - SSB4  Losers Finals - Smash Wii U	Video:M-uk5qYZpGY	Channel:UC_dkX2_MJZeiYZImFN8AOvg
Jeck 95 (Yoshi) vs SSHQ StreetShark (Sonic) - SSB4 Winners Finals - Smash Wii U	Video:iS8MOd4SF4o	Channel:UC_dkX2_MJZeiYZImFN8AOvg
MVG Ryo (Ike) vs MVG Sol (Little Mac) - SSB4 Losers Semis - Smash Wii U	Video:OBoUFo8xp0A	Channel:UC_dkX2_MJZeiYZImFN8AOvg
EsportsDolo (Diddy Kong) vs MVG Sol (Little Mac) - SSB4 Losers R9 - Smash Wii U	Video:QEcGXQYxTeE	Channel:UC_dkX2_MJZeiYZImFN8AOvg
EsportsDolo (Diddy Kong) vs SSB Jag (Wario) - SSB4 Losers Quarters - Smash Wii U	Video:u-UMbJoE9II	Channel:UC_dkX2_MJZeiYZImFN8AOvg
MVG Ryo (Ike) vs Saj (Peach) - SSB4 Losers Quarters - Smash Wii U	Video:T38v6SgkKpM	Channel:UC_dkX2_MJZeiYZImFN8AOvg
MVG Ryo (Ike) vs DewDaDash (Diddy Kong) - SSB4 Losers R8 - Smash Wii U	Video:PHvVfiZ5yhI	Channel:UC_dkX2_MJZeiYZImFN8AOvg
MVG Ryo (Ike) vs SSHQ GDX (Diddy Kong & Wario) - SSB4 Losers R7 - Smash Wii U	Video:beljLxkqP8w	Channel:UC_dkX2_MJZeiYZImFN8AOvg
MVG Sol (Little Mac) vs SSHQ StreetShark (Sonic) - SSB4 Winners Quarters - Smash Wii U	Video:76TykYruW6M	Channel:UC_dkX2_MJZeiYZImFN8AOvg
Saj (Peach) vs Jeck 95 (Yoshi) - SSB4 Winners R5 - Smash Wii U	Video:ZA-Y6mhdGAQ	Channel:UC_dkX2_MJZeiYZImFN8AOvg
MVG Ryo (Ike) vs Hi Hatz (Game & Watch & Ganondorf) - SSB4 Losers R5 - Smash Wii U	Video:r5wCRJMAsWw	Channel:UC_dkX2_MJZeiYZImFN8AOvg
0Rocket (Diddy Kong & Meta Knight) vs MVG Sol (Little Mac) - SSB4 Winners R5 - Smash Wii U	Video:D87ir5Ahi2I	Channel:UC_dkX2_MJZeiYZImFN8AOvg
SSHQ GDX (Wario) vs SSHQ StreetShark (Sonic) - SSB4 Winners Quarters - Smash Wii U	Video:Ht69Wteryyw	Channel:UC_dkX2_MJZeiYZImFN8AOvg
SSHQ GDX (Wario) vs BBG AdmiralFunk (Morton) - SSB4 Winners R4 - Smash Wii U	Video:4TBNDIUK6Yw	Channel:UC_dkX2_MJZeiYZImFN8AOvg
MVG Ryo (Ike) vs Haru (Marth) - SSB4 Losers R4 - Smash Wii U	Video:hClkZaRJlS4	Channel:UC_dkX2_MJZeiYZImFN8AOvg
EsportsDolo (Diddy Kong) vs H1 H4TZ (Luigi) SSB4 Winners R4 - Smash Wii U	Video:E5IuJglFjHA	Channel:UC_dkX2_MJZeiYZImFN8AOvg
MVG Sol (Little Mac) vs TFS SGJet (Shulk) SSB4 Winners R4 - Smash Wii U	Video:62LYob7y5OA	Channel:UC_dkX2_MJZeiYZImFN8AOvg
Saj (Peach) vs OC LuMiSaDi (Falco) SSB4 Winners R4 - Smash Wii U	Video:uHwu8AXRg-8	Channel:UC_dkX2_MJZeiYZImFN8AOvg
EsportsDolo (Diddy Kong) vs 212 Degrees (Captain Falcon) SSB4 Winners R3 - Smash Wii U	Video:EW8d0Yy_pPg	Channel:UC_dkX2_MJZeiYZImFN8AOvg
SuperSnarflepuff (Diddy Kong & Duck Hunt) vs DewDaDash (Ness & Sheik) SSB4 Winners R3   Smash Wii U	Video:_EDcejbQQg0	Channel:UC_dkX2_MJZeiYZImFN8AOvg
MVG Sol (Little Mac) vs  ROB (Captain Falcon) SSB4 Winners R3 - Smash Wii U	Video:nfsi1668A08	Channel:UC_dkX2_MJZeiYZImFN8AOvg
MVG Smash Conference: MVG Ryo (Ike & Lucina) vs Dirty Dan (Mario) SSB4 Winners R1 - Smash Wii U	Video:2ZXPH4d4jck	Channel:UC_dkX2_MJZeiYZImFN8AOvg
Ryu Smash Wii U Character Analysis - Mew2King	Video:v4TK_1yU_os	Channel:UC_dkX2_MJZeiYZImFN8AOvg
Lucas Smash Wii U Character Analysis - Mew2King	Video:VyV0bnTBGvQ	Channel:UC_dkX2_MJZeiYZImFN8AOvg
Roy Smash Wii U Character Analysis - Mew2King	Video:OTJdCNlPycs	Channel:UC_dkX2_MJZeiYZImFN8AOvg
Level 9 Handicapped Ganondorf - Sub Challenge (Mew2King)	Video:2IW3R8FohaA	Channel:UC_dkX2_MJZeiYZImFN8AOvg
How To Wavedash - Mew2King	Video:KyZ-e3gUzMw	Channel:UC_dkX2_MJZeiYZImFN8AOvg
MVG Vex 9.0 Classic WR of 8:28 with DDD no customs or equipment	Video:9xZHikdgCjM	Channel:UC_dkX2_MJZeiYZImFN8AOvg
SC 32: $50 Money Match - MVG Ryo (Ike) vs. MVG Sol (Little Mac)	Video:IVxGoovkIZc	Channel:UC_dkX2_MJZeiYZImFN8AOvg
"I forgot what we were talking about"	Video:IWFGg0QKXdw	Channel:UC_dkX2_MJZeiYZImFN8AOvg
MVG Sandstorm: Singles Top 8 GF - [A]rmada (Peach) vs. Westballz (Falco)	Video:PNGOq3CfGVY	Channel:UC_dkX2_MJZeiYZImFN8AOvg
MVG Sandstorm: Doubles W3 - MVG | TAI + MVG | Medz vs. Gahtzu + Westballz	Video:NycIJ-_dI6s	Channel:UC_dkX2_MJZeiYZImFN8AOvg
MVG Sandstorm Top 6 + random friendlies (will cut up soon to proper matches)	Video:m6l6Hemgol8	Channel:UC_dkX2_MJZeiYZImFN8AOvg
MVG Sandstorm: Singles WS - Nairo (ZSS) vs. MVG COG| Mew2king	Video:kwgFrx5QkFs	Channel:UC_dkX2_MJZeiYZImFN8AOvg
MVG Sandstorm: Doubles GF - MVD + Z vs. MVG COG | MewKing + ZeRo	Video:a8IJFY1xRuc	Channel:UC_dkX2_MJZeiYZImFN8AOvg
MVG Sandstorm: Singles LQ - Apachai (Little Mac) vs. SE | K9sBruce (Sheik)	Video:3Quh0T6CjnI	Channel:UC_dkX2_MJZeiYZImFN8AOvg
MVG Sandstorm: Singles WS - MVD (Diddy Kong) vs. ZeRo (Diddy Kong)	Video:Hr0YCPvlAE8	Channel:UC_dkX2_MJZeiYZImFN8AOvg
MVG Sandstorm: Doubles LF - MVD + Z vs. JA3 + Nairo	Video:faDn-HiUTh8	Channel:UC_dkX2_MJZeiYZImFN8AOvg
MVG Sandstorm: Doubles LS - Kinzer + Xero vs. JA3 + Nairo	Video:61aB4wGECG0	Channel:UC_dkX2_MJZeiYZImFN8AOvg
MVG Sandstorm : Doubles WF - MVD + Z vs. MVG COG | Mew2king + ZeRo	Video:Ysfe_OJTVv0	Channel:UC_dkX2_MJZeiYZImFN8AOvg
MVG Sandstorm: Doubles LS - Kinser + Xero vs. MVG SS + SE | K9sBruce	Video:XnI7mfbA0Co	Channel:UC_dkX2_MJZeiYZImFN8AOvg
MVG Sandstorm: Doubles - MVD + Z vs. MVG | SS + SE | K9sBruce	Video:avLVEgHik-4	Channel:UC_dkX2_MJZeiYZImFN8AOvg
MVG Sandstorm: Doubles - SFHG3 + Nairo vs. ZeRo + MVG COG | Mew2king	Video:gFKrxEf6-1o	Channel:UC_dkX2_MJZeiYZImFN8AOvg
MVG Sandstorm: Singles - Z (Pikachu) vs. AirVault (Marth)	Video:q3bqo6XJ1ow	Channel:UC_dkX2_MJZeiYZImFN8AOvg
MVG Sandstorm: Singles - Z (Pikachu) vs. MVG COG | Mew2king (Diddy Kong)	Video:XF4eFMacpKg	Channel:UC_dkX2_MJZeiYZImFN8AOvg
MVG Sandstorm: Singles - Asotil (Luigi) vs. Apachad (Little Mac)	Video:8dDOrOZBLys	Channel:UC_dkX2_MJZeiYZImFN8AOvg
MVG Sandstorm: Singles - Light (Captain Falcon) vs. Liquid'HungryBox (Jigglypuff)	Video:GlXCoYS7kqY	Channel:UC_dkX2_MJZeiYZImFN8AOvg
MVG Sandstorm: Singles - Funkermonster (Mega Man) vs. Liquid'HungryBox (Jigglypuff)	Video:2u4ZkI360Zc	Channel:UC_dkX2_MJZeiYZImFN8AOvg
MVG Sandstorm: Singles - Xero (Rosalina) vs. AirVault (Marth)	Video:HzxYy04DEes	Channel:UC_dkX2_MJZeiYZImFN8AOvg
MVG Sandstorm: Singles - Asotil (Luigi) vs. Sonic Mega (Mega Man)	Video:nSme1_GBckg	Channel:UC_dkX2_MJZeiYZImFN8AOvg
MVG Sandstorm: Singles - Asotil (Mii Fighter) vs. DarkShifter (Luigi)	Video:cKVDJIGsBzk	Channel:UC_dkX2_MJZeiYZImFN8AOvg
MVG Sandstorm: Singles - Crup (Captain Falcon) vs. K9sBruce (Sheik)	Video:tR4ZgEG9Kgo	Channel:UC_dkX2_MJZeiYZImFN8AOvg
MVG Sandstorm: Singles - Nairo (ZSS) vs. MVG | SS (Villager)	Video:rhQAkNBqc14	Channel:UC_dkX2_MJZeiYZImFN8AOvg
MVG Sandstorm: Singles - MVD (Diddy Kong) vs. K9sBruce (Sheik)	Video:iF8xFzXyg2k	Channel:UC_dkX2_MJZeiYZImFN8AOvg
MVG Sandstorm: Singles - ZeRo (Diddy Kong) vs. Apachad (Little Mac)	Video:AvlA1pCNBzw	Channel:UC_dkX2_MJZeiYZImFN8AOvg
MVG Sandstorm: Singles - ZeRo (Diddy Kong) vs. Xero (Rosalina)	Video:iW5_jGGp49s	Channel:UC_dkX2_MJZeiYZImFN8AOvg
MVG Sandstorm: Singles - Nairo (ZSS) vs. ST | Bam (Sonic)	Video:2ZFmfpeApRk	Channel:UC_dkX2_MJZeiYZImFN8AOvg
MVG Sandstorm: Singles - MVD (Duck Hunt) vs. Juan (R.O.B.)	Video:HagMMJor2u8	Channel:UC_dkX2_MJZeiYZImFN8AOvg
MVG Sandstorm: Singles - SE | K9sBruce (Sheik/Falcon) vs. Light (Pikachu/Falcon)	Video:na2A79Mdul8	Channel:UC_dkX2_MJZeiYZImFN8AOvg
MVG Sandstorm: Singles - Liquid'HungryBox (Jigglypuff) vs. Xero (Rosalina)	Video:JcZkRG6HgSM	Channel:UC_dkX2_MJZeiYZImFN8AOvg
MVG Sandstorm: Singles - SE | K9sBruce (Sheik) vs. Cascade (Sonic)	Video:mZiUMoNCVt0	Channel:UC_dkX2_MJZeiYZImFN8AOvg
MVG Sandstorm: Singles - TGZ Freean (R.O.B.) vs. Z (Pikachu)	Video:iRD5oafqWhE	Channel:UC_dkX2_MJZeiYZImFN8AOvg
MVG Sandstorm: Singles - Funkermonster (Greninja) vs. Sonic Mega (Mega Man)	Video:HreHbm-rAOY	Channel:UC_dkX2_MJZeiYZImFN8AOvg
MVG Sandstorm: Singles - Wafty (Mii Fighter) vs. ZeRo (Diddy Kong)	Video:KnT-aKGmk6g	Channel:UC_dkX2_MJZeiYZImFN8AOvg
MVG Sandstorm: Singles - Dansdaman (ZSS/Falcon) vs. Juan (R.O.B.)	Video:o5V_mL9_49E	Channel:UC_dkX2_MJZeiYZImFN8AOvg
MVG Sandstorm: Melee After-Tournament Interviews	Video:GtoDE4-jGZY	Channel:UC_dkX2_MJZeiYZImFN8AOvg
MVG Sandstorm: Top 8 Singles LF - Westballz (Falco) vs. MVG | AXE (Pikachu)	Video:8cE1dim1Tzg	Channel:UC_dkX2_MJZeiYZImFN8AOvg
MVG Sandstorm: Singles Top 8 LS - Westballz (Falco) vs. Liquid'HungryBox (Jigglypuff) 2nd half	Video:cW9QPrZruAw	Channel:UC_dkX2_MJZeiYZImFN8AOvg
MVG Sandstorm: Singles Top 8 WF - [A]rmada (Peach) vs. MVG | AXE (Pikachu)	Video:TUlqmmee9mE	Channel:UC_dkX2_MJZeiYZImFN8AOvg
MVG Sandstorm: Singles Top 8 L8 - Westballz (Falco) vs. C9 | Mango (Fox)	Video:prEwbY4fyfw	Channel:UC_dkX2_MJZeiYZImFN8AOvg
MVG Sandstorm: Singles Top 8 L8 - TSM | Leffen (Fox) vs. Liquid'HungryBox (Jigglypuff)	Video:H7nFcKIMLaQ	Channel:UC_dkX2_MJZeiYZImFN8AOvg
MVG Sandstorm: Top 8 Singles L7 - S2J (C. Falcon) vs. Westballz (Falco)	Video:xbRUdgV7F7Y	Channel:UC_dkX2_MJZeiYZImFN8AOvg
MVG Sandstorm: Top 8 Singles WS - [A]rmada (Fox) vs. Liquid'HungryBox (Jigglypuff)	Video:4O0AIZwO_WI	Channel:UC_dkX2_MJZeiYZImFN8AOvg
MVG Sandstorm: Top 8 Singles WS - C9 | Mango (Fox) vs. MVG | AXE (Pikachu)	Video:Ro8OWoDhQa4	Channel:UC_dkX2_MJZeiYZImFN8AOvg
MVG Sandstorm: Top 8 Singles LS7 - TSM | Leffen (Fox) vs. MacD (Peach)	Video:92mu7Zc2QJk	Channel:UC_dkX2_MJZeiYZImFN8AOvg
MVG Sandstorm: Top 8 singles L6 - Westballz (Falco) vs. Gahtzu (C. Falcon)	Video:deTfAg2HqMQ	Channel:UC_dkX2_MJZeiYZImFN8AOvg
MVG Sandstorm: Singles W4 - Gahtzu (C. Falcon) vs. Liquid'HungryBox (Jigglypuff)	Video:aSSjVy5Ba40	Channel:UC_dkX2_MJZeiYZImFN8AOvg
MVG Sandstorm: Singles L6 - MacD (Peach) vs. HugS (Samus)	Video:-j5gJaIFT2Y	Channel:UC_dkX2_MJZeiYZImFN8AOvg
MVG Sandstorm: Singles L5 - HugS (Samus) vs. JackieTran.com (Luigi)	Video:bqZJr5kdS6E	Channel:UC_dkX2_MJZeiYZImFN8AOvg
MVG Sandstorm: Singles W4 - TSM | Leffen (Fox) vs. MVG | AXE (Pikachu)	Video:hpYRiwD-v5Y	Channel:UC_dkX2_MJZeiYZImFN8AOvg
MVG Sandstorm: Singles W4 - C9 | Mango (Fox) vs. MacD (Peach)	Video:w7jI4VKovBw	Channel:UC_dkX2_MJZeiYZImFN8AOvg
MVG Sandstorm: Singles W4 - [A]rmada (Peach) vs. FX_DFW | Wobbles (Ice Climbers)	Video:IV3S414nZxg	Channel:UC_dkX2_MJZeiYZImFN8AOvg
MVG Sandstorm: Singles R2 - Gahtzu (C. Falcon) vs. Silly Kyle (Peach)	Video:brJc_uMkl3k	Channel:UC_dkX2_MJZeiYZImFN8AOvg
MVG Sandstorm: Singles W3 - Kira (Sheik) vs. FX_DFW | Wobbles (Ice Climbers)	Video:MZ2CFlDVW5c	Channel:UC_dkX2_MJZeiYZImFN8AOvg
MVG Sandstorm : Singles W2 - [A]rmada (Peach) vs. Liquid'Ken (Marth)	Video:FBHYT66i4AU	Channel:UC_dkX2_MJZeiYZImFN8AOvg
MVG Sandstorm: Singles W2 - Kira (Sheik) vs. GG7 (C. Falcon)	Video:_D-xc3vwRc8	Channel:UC_dkX2_MJZeiYZImFN8AOvg
MVG Sandstorm: Singles W2 - MVG | TAI (Blue) vs. Liquid'Ken (Red)	Video:rB6bDvURq0o	Channel:UC_dkX2_MJZeiYZImFN8AOvg
MVG Sandstorm: Singles W1 - Forward (Blue) vs. Far! (Tan)	Video:CMMJm0vuDH4	Channel:UC_dkX2_MJZeiYZImFN8AOvg
MVG Sandstorm: Doubles GF - MVG COG | Mew2king + [A]rmada vs. MacD + TSM | Leffen	Video:8olG-_8Ndr4	Channel:UC_dkX2_MJZeiYZImFN8AOvg
MVG Sandstorm: Doubles LF - Liquid'HungryBox + SIlly Kyle vs. MVG COG | Mew2king vs. [A]rmada	Video:C8COb7gRaQM	Channel:UC_dkX2_MJZeiYZImFN8AOvg
MVG Sandstorm: Doubles LS - Liquid'HungryBox + Silly Kyle vs. MVG | AXE + Forward	Video:xzMgmSPg304	Channel:UC_dkX2_MJZeiYZImFN8AOvg
MVG Sandstorm: Doubles LQ - Liquid'HungryBox + Silly Kyle vs. Kira + S2J	Video:uMHG-132-C0	Channel:UC_dkX2_MJZeiYZImFN8AOvg
MVG Sandstorm: Doubles WS - MVG COG | Mew2king + [A]rmada vs. TSM | Leffen + MacD	Video:OnYpKrO7O_Y	Channel:UC_dkX2_MJZeiYZImFN8AOvg
MVG Sandstorm: Doubles WS - MVG COG | Mew2king + [A]rmada vs. S2J + Kira	Video:4DsuCwnr8kY	Channel:UC_dkX2_MJZeiYZImFN8AOvg
MVG Sandstorm: Doubles L7 - Silly Kyle + Liquid'HungryBox vs. Gahtzu + Westballz	Video:maYnBou22kE	Channel:UC_dkX2_MJZeiYZImFN8AOvg
MVG Sandstorm: Doubles LQ - Forward + MVG | AXE vs. Taj + Wobbles	Video:bBB97hC_FfE	Channel:UC_dkX2_MJZeiYZImFN8AOvg
MVG Sandstorm: Doubles L6 - Liquid'HungryBox + Silly Kyle vs. OkamiBW + Liquid'Ken	Video:rZLHgi8TxLU	Channel:UC_dkX2_MJZeiYZImFN8AOvg
MVG Sandstorm: Doubles WS - TSM | Leffen + MacD vs. MVG | AXE + Forward	Video:rHclWQGSuH8	Channel:UC_dkX2_MJZeiYZImFN8AOvg
MVG Sandstorm: Doubles W4 - TSM | Leffen + MacD vs. Gahtzu + Westballz	Video:Fn0prcpaN9A	Channel:UC_dkX2_MJZeiYZImFN8AOvg
MVG Sandstorm: Doubles W4 - JimJamFlimFlam + SICDF vs. Kira + S2J	Video:1W1chKAfigM	Channel:UC_dkX2_MJZeiYZImFN8AOvg
MVG Sandstorm: Doubles W4 - Liquid'HungryBox + Silly Kyle vs. MVG | AXE + Forward	Video:oeFUSEI7TgM	Channel:UC_dkX2_MJZeiYZImFN8AOvg
MVG Sandstorm: Doubles W3 - FX_DFW | Wobbles + MVG GDLK | Taj vs. Liquid'Ken + OkamiBW	Video:O7Y7vu7RpbE	Channel:UC_dkX2_MJZeiYZImFN8AOvg
MVG Sandstorm: Doubles W3 - MVG | AXE + Forward vs. Girku + Eef	Video:uHKHplomJmA	Channel:UC_dkX2_MJZeiYZImFN8AOvg
MVG Sandstorm: Doubles W2 - MVG COG | Mew2king + [A]rmada vs. Stone Watcher + Bell	Video:Bp7D72w-Rfo	Channel:UC_dkX2_MJZeiYZImFN8AOvg
MVG Sandstorm: Doubles W2 - TSM | Leffen + MacD vs. Joshuwasha + Scape	Video:iBijF_WAyhY	Channel:UC_dkX2_MJZeiYZImFN8AOvg
MVG Sandstorm: Doubles W2 - Cornholio + Peachfuzz vs. MVG | TAI + MVG | Medz	Video:U-DIVdax4BM	Channel:UC_dkX2_MJZeiYZImFN8AOvg
MVG Sandstorm: Doubles W2 - FX_DFW | Wobbles + MVG GDLK | Taj vs. Deltron + Nerin	Video:489Vo6suUa0	Channel:UC_dkX2_MJZeiYZImFN8AOvg
MVG Sandstorm: Singles RR - GMo (Green Fox) vs. HF Neon (Blue Fox/Falco	Video:yNL3CFHS6gI	Channel:UC_dkX2_MJZeiYZImFN8AOvg
MVG Sandstorm: Singles RR - JackieTran.com (Luigi/Marth/Falco) vs. TrevynThot (Link)	Video:MXsviPmHogk	Channel:UC_dkX2_MJZeiYZImFN8AOvg
MVG Sandstorm: Singles RR - ForteFreak (Sheik/Marth) vs. Bacon (Falco)	Video:_Vn7ihHDmRc	Channel:UC_dkX2_MJZeiYZImFN8AOvg
MVG Sandstorm: Singles RR - Glitch (Ice Climbers) vs. JpegImage (Falcon)	Video:E8_TIhU6elM	Channel:UC_dkX2_MJZeiYZImFN8AOvg
MVG Sandstorm: Singles RR - Metal (Marth) vs. Holy Nugz (Fox)	Video:v3Fe6k9xKTs	Channel:UC_dkX2_MJZeiYZImFN8AOvg
MVG Sandstorm: Singles RR - MVG | Medz (Fox) vs. Daouzin (Ganondorf)	Video:_nVEiGdlmJ4	Channel:UC_dkX2_MJZeiYZImFN8AOvg
MVG Sandstorm: Singles RR - MVG | TAI (Marth) vs. Moneypants (Luigi)	Video:riDY4f3BaWE	Channel:UC_dkX2_MJZeiYZImFN8AOvg
MVG Sandstorm: Singles RR - TSM | Leffen (Fox) vs. Bell (Marth)	Video:3D23P3fTWYY	Channel:UC_dkX2_MJZeiYZImFN8AOvg
MVG Sandstorm: Singles RR - FX_DFW | Wobbles (Ice Climbers) vs. Tribulation (Ganondorf)	Video:gPAApDixopI	Channel:UC_dkX2_MJZeiYZImFN8AOvg
MVG Sandstorm: Singles RR - Forward (Falco) vs. AppleApple (Fox)	Video:lekn5RFmG7g	Channel:UC_dkX2_MJZeiYZImFN8AOvg
MVG Sandstorm: Singles RR - MVG | TAI (Marth) vs. Douchebag Dylan (C. Falcon)	Video:q5TSmEYbHsY	Channel:UC_dkX2_MJZeiYZImFN8AOvg
MVG Sandstorm: Singles RR - Gahtzu (C. Falcon) vs. Shiv (Fox)	Video:bOI6gHlEPJA	Channel:UC_dkX2_MJZeiYZImFN8AOvg
MVG Sandstorm: Singles RR - MVG | AXE (Pikachu) vs. Dansdaman (Sheik)	Video:PQr7Z61SNNc	Channel:UC_dkX2_MJZeiYZImFN8AOvg
Tai (Marth) vs ZeRo (Fox) - SSBM Friendlies	Video:Sd8PLUrukUg	Channel:UC_dkX2_MJZeiYZImFN8AOvg
Event 33: Mew2king vs Axe, Hero, Douchebag Dylan	Video:Zfg4lYa7iq0	Channel:UC_dkX2_MJZeiYZImFN8AOvg
MY STRATEGY IS WORKING (feat. Mew2king)	Video:SqriItCtorQ	Channel:UC_dkX2_MJZeiYZImFN8AOvg
Greggalina is broken! (ZeRo's Brawler Mii vs. M2K's Standard Diddy)	Video:q-JJLTVzaV4	Channel:UC_dkX2_MJZeiYZImFN8AOvg
MVG Tournament: TAI (Marth) vs. GG7 (C. Falcon)	Video:yqH5Qzrnek4	Channel:UC_dkX2_MJZeiYZImFN8AOvg
MVG Tournament LS: Wafty (Wario) vs. SFA | SS (Villager)	Video:FglJpll_53Q	Channel:UC_dkX2_MJZeiYZImFN8AOvg
MVG Tournament WS: MVG | Mew2king (Diddy Kong) vs. AZHP | K9 (Sheik)	Video:KlttYzK3mLo	Channel:UC_dkX2_MJZeiYZImFN8AOvg
MVG Tournament: MVG | Mew2king (Diddy Kong) vs. SFA | SS (Villager)	Video:Kfm2UHmL9Yg	Channel:UC_dkX2_MJZeiYZImFN8AOvg
MVG Tournament GF: MVG | Mew2king (Sheik) vs. MOR | AXE (Pikachu)	Video:GoNGtLYHpJw	Channel:UC_dkX2_MJZeiYZImFN8AOvg
MVG Tournament LF: MOR | AXE (Pikachu/Falco) vs. Forward (Sheik/Fox/Falco)	Video:g60SzgkD7Nw	Channel:UC_dkX2_MJZeiYZImFN8AOvg
MVG Tournament LS: XTR | Medz (Fox) vs. Forward (Falco)	Video:mPR3-8P5PxU	Channel:UC_dkX2_MJZeiYZImFN8AOvg
MVG Tournament WF: MVG | Mew2king (Sheik) vs. MOR | AXE (Pikacu)	Video:bdkAloaTKaQ	Channel:UC_dkX2_MJZeiYZImFN8AOvg
MVG Tournament: Tagless Kyle (Marth) vs. Forward (Sheik)	Video:FiWXhImtCDg	Channel:UC_dkX2_MJZeiYZImFN8AOvg
MVG Tournament: XTR | Medz (Fox) vs. MOR | AXE (Pikachu)	Video:jWLG2mNYZ2k	Channel:UC_dkX2_MJZeiYZImFN8AOvg
MVG Tournament: Oksas (Blue Falcon) vs. GG7 (Black Falcon)	Video:sVG8YFCvz9s	Channel:UC_dkX2_MJZeiYZImFN8AOvg
MVG Tournament: TAI (Blue Marth) vs. MVG | Mew2king (Black Marth)	Video:vrmdAIXCZFM	Channel:UC_dkX2_MJZeiYZImFN8AOvg
MVG Tournament: XTR | Medz (Fox) vs. Forward (Falco)	Video:HrCIWl11AP4	Channel:UC_dkX2_MJZeiYZImFN8AOvg
MVG Tournament: Forward (Falco) vs. Vitro (Marth/Ganon)	Video:QVz8QPhCVVk	Channel:UC_dkX2_MJZeiYZImFN8AOvg
MVG Tournament: Kalirmari (Fox) vs. Oksas (C. Falcon)	Video:LCP5e2iEG4w	Channel:UC_dkX2_MJZeiYZImFN8AOvg
MVG Tournament: Samurai Jack (Marth) vs. MVG | Mew2king (Sheik/MewTwo)	Video:DmzgpTUqBLs	Channel:UC_dkX2_MJZeiYZImFN8AOvg
MVG Tournament: Harlock vs. Sai and Lime  vs. EG Goeman	Video:Ej95VlwOyWs	Channel:UC_dkX2_MJZeiYZImFN8AOvg
MVG Tournament: Nightmare (Ness) vs. Ryan (R.O.B.)	Video:W45pwZHxw_s	Channel:UC_dkX2_MJZeiYZImFN8AOvg
MVG Tournament: Blur (Fox) vs. NoirScythe (MewTwo)	Video:Qbox1Y0Bsyo	Channel:UC_dkX2_MJZeiYZImFN8AOvg
MVG Tournament: XTR | Medz (Black Falcon) vs. Jehuty (Normal Falcon)	Video:2KhA9WbK43s	Channel:UC_dkX2_MJZeiYZImFN8AOvg
MVG Tournament: Ninji (Fox/Falco) vs. Tagless Kyle (Roy)	Video:ogxeH7xbtDQ	Channel:UC_dkX2_MJZeiYZImFN8AOvg
MVG Tournament: Roman (Shulk) vs. SamuraiPanda (Sonic)	Video:hIJXIvrGpIs	Channel:UC_dkX2_MJZeiYZImFN8AOvg
MVG Tournament: SFA | SS (Ness) vs. Lime (Yoshi)	Video:-gdZT4XgFQY	Channel:UC_dkX2_MJZeiYZImFN8AOvg
MVG Tournament: Dante Ares (Ness/Lucario) vs. MVG | Mew2king (Diddy Kong)	Video:3CM3GPlvZAY	Channel:UC_dkX2_MJZeiYZImFN8AOvg
MVG Tournament: AZHP | K9 (Sheik) vs. Nom (Greninja)	Video:ukmynP8HstQ	Channel:UC_dkX2_MJZeiYZImFN8AOvg
MVG Tournament: Grimm (Morton) vs. RockJerk (C. Falcon)	Video:1XqrPWmNEu0	Channel:UC_dkX2_MJZeiYZImFN8AOvg
MVG Tournament: Matty Ice (Dedede) vs. Davantus (Ness)	Video:d8Hi3W3tpqY	Channel:UC_dkX2_MJZeiYZImFN8AOvg
MVG Tournament: Matty Ice (Diddy Kong/Jigglypuff) vs. TimmyAZ (Dedede)	Video:9qcxO_EnDb8	Channel:UC_dkX2_MJZeiYZImFN8AOvg
MVG Tournament: SFA Wafty (Wario) vs. GV7 (R.O.B.)	Video:ZuWeCjHOF6U	Channel:UC_dkX2_MJZeiYZImFN8AOvg
MVG Tournament: Spank (Sheik) vs. Glitch (Ice Climbers)	Video:ADo3XU6TfWc	Channel:UC_dkX2_MJZeiYZImFN8AOvg
MVG Tournament: HF Neon (Fox) vs. Fairy (Peach)	Video:7X1F7QS1r-s	Channel:UC_dkX2_MJZeiYZImFN8AOvg
MVG Tournament: Glitch (Ice Climbers) vs. Vitro (Ganon)	Video:K5CayUinGFc	Channel:UC_dkX2_MJZeiYZImFN8AOvg
MVG Tournament: Samurai Jack (Marth) vs. GG7 (C. Falcon)	Video:KC_jx6qjoXI	Channel:UC_dkX2_MJZeiYZImFN8AOvg
MVG Tournament: Cheesus (White Marth/Ganon) vs. TAI (Blue Marth)	Video:VksIbf3_aUg	Channel:UC_dkX2_MJZeiYZImFN8AOvg
MVG Tournament: Vhozek (Ganon) vs. HF Neon (Fox)	Video:t_8mrVwkf1Q	Channel:UC_dkX2_MJZeiYZImFN8AOvg
MVG Tournament: MVG | Mew2king (Sheik/Zelda) vs. Jare Bear (Samus)	Video:i9AEYcLEF98	Channel:UC_dkX2_MJZeiYZImFN8AOvg
