Project M Rank 2016 Top 50 Combo Video	Video:B7_r2rx4Z74	Channel:UC5WNBHwgluAwWJE5QV-5_TA
Project CLASH 26 - Weekly Philadelphia Project M Tournament	Video:U3g_WCy7uDA	Channel:UC5WNBHwgluAwWJE5QV-5_TA
Super Jab Reset 01 - Monthly Philadelphia Area Project M Tournament	Video:JvGFE-RbBRQ	Channel:UC5WNBHwgluAwWJE5QV-5_TA
Project M - Nyani (Ivysaur) vs Phire (Roy) - PC 20 Winners	Video:pF8u6GVh4Zw	Channel:UC5WNBHwgluAwWJE5QV-5_TA
Project M - DVD (Toon Link) vs The Man in Gauze (Link) - PC 20 Winners	Video:PXZ_ExglBoU	Channel:UC5WNBHwgluAwWJE5QV-5_TA
Project M - Counter (Roy) vs Switch (Charizard) - PC 20 Winners	Video:FtEYOV3tB7o	Channel:UC5WNBHwgluAwWJE5QV-5_TA
Project M - Sans (Ganondorf) vs GudBJ (Bowser) - PC 20 Winners	Video:CNUG-lm1ny4	Channel:UC5WNBHwgluAwWJE5QV-5_TA
Project M - Dusty (Marth) vs Aidan (Zero Suit Samus) - PC 19 Grand Finals	Video:RGaYeFr4nK4	Channel:UC5WNBHwgluAwWJE5QV-5_TA
Project M - Dusty (Marth) vs Quaza (Ike) - PC 19 Losers Finals	Video:BnWZ-bSXTSw	Channel:UC5WNBHwgluAwWJE5QV-5_TA
Project M - Fedrias (Squirtle) vs Quaza (Ike) - PC 19 Losers	Video:KzQQyNNTkV4	Channel:UC5WNBHwgluAwWJE5QV-5_TA
Project M - Dusty (Marth) vs Aidan (Zero Suit Samus) - PC 19 Winners Finals	Video:hgRUqBW3VXg	Channel:UC5WNBHwgluAwWJE5QV-5_TA
Project M - Vari (Mario) vs Fedrias (Squirtle) - PC 19 Losers	Video:a2R53nhG_Qk	Channel:UC5WNBHwgluAwWJE5QV-5_TA
Project M - Chibo (Samus) vs Quaza (Ike) - PC 19 Losers	Video:AXGsreqduu4	Channel:UC5WNBHwgluAwWJE5QV-5_TA
Project M - Chibo (King Dedede/Samus) vs Woody (Ness) - PC 19 Losers	Video:vWieM_pwmCw	Channel:UC5WNBHwgluAwWJE5QV-5_TA
Project M - Dusty (Marth) vs Vari (Mario) - PC 19 Winners	Video:WAWAG05GMUE	Channel:UC5WNBHwgluAwWJE5QV-5_TA
Project M - Dotcom (Olimar) vs Aidan (Zero Suit Samus) - PC 19 Winners	Video:uXh9HKt_wM4	Channel:UC5WNBHwgluAwWJE5QV-5_TA
Project M - Vari (Mario) vs Quaza (Ike) - PC 19 Winners	Video:ZWQq7JqDPZE	Channel:UC5WNBHwgluAwWJE5QV-5_TA
Project M - Fedrias (Squirtle) vs Dotcom (Olimar) - PC 19 Winners	Video:pXWh3Ds54GY	Channel:UC5WNBHwgluAwWJE5QV-5_TA
Project M - Dusty (Ness) vs Woody (Ness) - PC 19 Winners	Video:TiqWQJrfPR8	Channel:UC5WNBHwgluAwWJE5QV-5_TA
Project M - Maximum Leech (Roy) vs Aidan (Zero Suit Samus) - PC 19 Winners	Video:BDQUU6ixAOo	Channel:UC5WNBHwgluAwWJE5QV-5_TA
Project M - Dotcom (Olimar) vs Steller (Samus) - PC 19 Winners	Video:EqxF0JTk4Is	Channel:UC5WNBHwgluAwWJE5QV-5_TA
Project M - Chibo (Samus) vs Maximum Leech (Roy) - PC 19 Winners	Video:KhYVAWbaoiI	Channel:UC5WNBHwgluAwWJE5QV-5_TA
Project M - 10TC (Mr. Game and Watch) vs Woody (Ness) - PC 19 Winners	Video:R3kZSb-j7jY	Channel:UC5WNBHwgluAwWJE5QV-5_TA
Project CLASH 24 - Weekly Philadelphia Project M Tournament	Video:RJ1WMjEXB6k	Channel:UC5WNBHwgluAwWJE5QV-5_TA
Project M - DVD (Toon Link) vs Zubat (Yoshi) - Super PC 01 Grand Finals	Video:lGJa8QfXtK8	Channel:UC5WNBHwgluAwWJE5QV-5_TA
Project M - Aidan (Zero Suit Samus) vs Zubat (Yoshi) - Super PC 01 Losers Finals	Video:jf9LVWJPEyQ	Channel:UC5WNBHwgluAwWJE5QV-5_TA
Project M - Tunechi (Snake) vs Zubat (Luigi) - Super PC 01 Losers	Video:r1HdVFD4hdM	Channel:UC5WNBHwgluAwWJE5QV-5_TA
Project M - Tunechi (Snake) vs BStuck (ROB) - Super PC 01 Losers	Video:hYRGWCYvlUU	Channel:UC5WNBHwgluAwWJE5QV-5_TA
Project M - DVD (Toon Link) vs Aidan (Zero Suit Samus) - Super PC 01 Winners Finals	Video:f7MVh5PLpXc	Channel:UC5WNBHwgluAwWJE5QV-5_TA
Project M - BStuck (ROB) vs Aidan (Zero Suit Samus) - Super PC 01 Winners	Video:60Z4TM-kIjE	Channel:UC5WNBHwgluAwWJE5QV-5_TA
Project M - Zubat (Luigi) vs DVD (Toon Link) - Super PC 01 Winners	Video:ByKeNPZ81Og	Channel:UC5WNBHwgluAwWJE5QV-5_TA
Project M - Dusty (Marth) vs Aidan (ZSS) - Super PC 01 Winners	Video:v0tTUS1I6gY	Channel:UC5WNBHwgluAwWJE5QV-5_TA
Project M - Capitulize (Pikachu) vs Zubat (Luigi) - Super PC 01 Winners	Video:BAtZjaIsmWk	Channel:UC5WNBHwgluAwWJE5QV-5_TA
Project M - DVD (Toon Link) vs Tunechi (Snake) - Super PC 01 Winners	Video:h0NAyTqwLac	Channel:UC5WNBHwgluAwWJE5QV-5_TA
Project M - Kingtoon (Charizard) vs BStuck (ROB) - Super PC 01 Winners	Video:oY9U5jEeJME	Channel:UC5WNBHwgluAwWJE5QV-5_TA
Project M - Vari (Mario) vs Zubat (Luigi) - Super PC 01 Winners	Video:sdK7kZIGqPo	Channel:UC5WNBHwgluAwWJE5QV-5_TA
Project M - Dusty (Marth) vs Hondo (Fox) - Super PC 01 Winners	Video:aWuMFFmxQYI	Channel:UC5WNBHwgluAwWJE5QV-5_TA
Project M - Chibo (Samus) vs BStuck (ROB) - Super PC 01 Winners	Video:Nmt4x8O1m7A	Channel:UC5WNBHwgluAwWJE5QV-5_TA
Project M - Kingtoon (Charizard) vs Quaza (ZSS/Ike) - Super PC 01 Winners	Video:aMq1QlYnDgM	Channel:UC5WNBHwgluAwWJE5QV-5_TA
Project M - Wolftree (Wolf) vs Aidan (ZSS) - Super PC 01 Winners	Video:DdDyu1kxC-E	Channel:UC5WNBHwgluAwWJE5QV-5_TA
Project M - DVD (Toon Link) vs Cogzilla (Snake) - Super PC 01 Winners	Video:3-xaK0MZ0ig	Channel:UC5WNBHwgluAwWJE5QV-5_TA
Project M - Chibo (King Dedede) vs Stellar (Samus) - Super PC 01 Winners	Video:2pQAzFYOFZU	Channel:UC5WNBHwgluAwWJE5QV-5_TA
Project M - Kingtoon (Charizard) vs Captain Von Weasel (Mr. Game and Watch) - Super PC 01 Winners	Video:iDkYAbmgygk	Channel:UC5WNBHwgluAwWJE5QV-5_TA
Project M - Aidan (ZSS) vs Zidax (Marth) - Super PC 01 Winners	Video:BZDEB2pyyKQ	Channel:UC5WNBHwgluAwWJE5QV-5_TA
Project M - DVD & Aidan (Toon Link/ZSS) vs Zubat & Nevergreen (Luigi/Falcon) - Super PC 01 W. Finals	Video:0OBe4wk3zdY	Channel:UC5WNBHwgluAwWJE5QV-5_TA
Project M - Dusty & Kingtoon (Marth/Zard) vs Zubat & Nevergreen (Luigi/Falcon) - Super PC 01 Winners	Video:ItXm-qHsep8	Channel:UC5WNBHwgluAwWJE5QV-5_TA
Project M - Dusty & Kingtoon (Marth/Charizard) vs Hondo & Bstuck (ROB/Fox) - Super PC 01 Winners	Video:0lXnbrNhe9k	Channel:UC5WNBHwgluAwWJE5QV-5_TA
Super Project CLASH 02 - Monthly Philadelphia Project M Tournament	Video:dJIEV8ssplM	Channel:UC5WNBHwgluAwWJE5QV-5_TA
Project M - Interview with Switch - The True King	Video:y3QgOJCIUsI	Channel:UC5WNBHwgluAwWJE5QV-5_TA
Project M - Interview with Gallo - The True King	Video:VaymWkG0gOE	Channel:UC5WNBHwgluAwWJE5QV-5_TA
Project M - Switch (Wolf) vs Gallo (Mario) - The True King Grand Finals	Video:DOJ6DCsVWDs	Channel:UC5WNBHwgluAwWJE5QV-5_TA
Project M - Switch (Wolf) vs Aidan (ZSS) - The True King Losers Finals	Video:83cBXUFSgjw	Channel:UC5WNBHwgluAwWJE5QV-5_TA
Project M - Switch (Wolf) vs StereoKiDD (Ness) - The True King Losers	Video:CV3fuSdVNvE	Channel:UC5WNBHwgluAwWJE5QV-5_TA
Project M - Gallo (Mario) vs Aidan (ZSS) - The True King Winners Finals	Video:ggXU8qyK9WE	Channel:UC5WNBHwgluAwWJE5QV-5_TA
Project M - Switch (Wolf) vs Malachi (Peach) - The True King Losers	Video:wd-V-eIkICw	Channel:UC5WNBHwgluAwWJE5QV-5_TA
Project M - Yung Quaff (Meta Knight) vs StereoKiDD (Ness) - The True King Losers	Video:JVP-qcS2Tx8	Channel:UC5WNBHwgluAwWJE5QV-5_TA
Project M - Envy (Ike/Fox/Diddy) vs Malachi (Sheik) - The True King Losers	Video:4ON5GDzZcsw	Channel:UC5WNBHwgluAwWJE5QV-5_TA
Project M - Aidan (ZSS) vs StereoKiDD (Ness) - The True King Winners	Video:8H76ToCIf0A	Channel:UC5WNBHwgluAwWJE5QV-5_TA
Project M - Switch (Wolf) vs Gallo (Mario) - The True King Winners	Video:zU-rRcnn6uI	Channel:UC5WNBHwgluAwWJE5QV-5_TA
Project M - Malachi (Sheik/Peach) vs Aidan (ZSS) - The True King Winners	Video:-Y8oEDvlYOI	Channel:UC5WNBHwgluAwWJE5QV-5_TA
Project M - Envy (Ike) vs StereoKiDD (Ness) - The True King Winners	Video:wNyfxPd6Vxo	Channel:UC5WNBHwgluAwWJE5QV-5_TA
Project M - Yung Quaff (Meta Knight) vs Gallo (Mario) - The True King Winners	Video:pBVUL5EIL6w	Channel:UC5WNBHwgluAwWJE5QV-5_TA
Project M - Switch (Wolf) vs Tunechi (Snake) - The True King Winners	Video:T77Us7ke8BY	Channel:UC5WNBHwgluAwWJE5QV-5_TA
Project M - GP (Fox) vs Envy (Ike) - The True King Winners	Video:FosS-8ClEPI	Channel:UC5WNBHwgluAwWJE5QV-5_TA
Project M - Aidan (ZSS) vs Twisty (Wario) - The True King Winners	Video:htD1_JSZBcA	Channel:UC5WNBHwgluAwWJE5QV-5_TA
Project M - Keychain (Wario) vs Aidan (ZSS) - The True King Winners	Video:b-W9BrJGmzg	Channel:UC5WNBHwgluAwWJE5QV-5_TA
Project M - Cheesecake (Sheik) vs Switch (Wolf) - The True King Winners	Video:T2NtTN7xG48	Channel:UC5WNBHwgluAwWJE5QV-5_TA
Project M - Chibo (Samus) vs Sans (Ganondorf) - The True King Winners	Video:cR-O1Cl3rHM	Channel:UC5WNBHwgluAwWJE5QV-5_TA
Project M - Prime (Mario) vs Swoosh (Ness) - The True King Winners	Video:P_XjGLKnXa4	Channel:UC5WNBHwgluAwWJE5QV-5_TA
Project M - Envy & DVD (Toon Link/Ike) vs Switch & Gallo (Wolf/Mario) - The True King Grand Finals	Video:il4U0tUjTSU	Channel:UC5WNBHwgluAwWJE5QV-5_TA
Project M - Boiko & GP (Ness/Fox) vs Switch & Gallo (Wolf/Mario) - The True King Losers Finals	Video:Oqc-JV3WKaU	Channel:UC5WNBHwgluAwWJE5QV-5_TA
Project M - Boiko & GP (Ness/Fox) vs Yung Quaff & Twisty (Meta Knight/Wario) - The True King Losers	Video:rrl4-zk7c00	Channel:UC5WNBHwgluAwWJE5QV-5_TA
Project M - DVD & Envy (Toon Link/Ike) vs Switch & Gallo (Wolf/Mario) - The True King Winners Finals	Video:qV8GnATpbZg	Channel:UC5WNBHwgluAwWJE5QV-5_TA
Project M - DVD & Envy (Toon Link/Diddy) vs Yung Quaff & Twisty (Wario/MK) - The True King Winners	Video:CbWSYQSczhA	Channel:UC5WNBHwgluAwWJE5QV-5_TA
Project M - Switch & Gallo (Wolf/Mario) vs Boiko & GP (Fox/Meta Knight) - The True King Winners	Video:02dZe6PmdHs	Channel:UC5WNBHwgluAwWJE5QV-5_TA
Project M - Narq & StereoKiDD (Lucas/Ness) vs Yung Quaff & Twisty (Wario/MK) - The True King Winners	Video:43WIJpnQUG4	Channel:UC5WNBHwgluAwWJE5QV-5_TA
Project M - CruzyCakes & Vino (Fox/Sonic) vs Switch & Gallo (Wolf/Mario) - The True King Winners	Video:Pq7YoEUMRS4	Channel:UC5WNBHwgluAwWJE5QV-5_TA
Project M - Robfox & SlimStacey (Bowser/MK) vs Keychain & Royals (DDD/Sheik) - The True King Winners	Video:Ommqr6YqSek	Channel:UC5WNBHwgluAwWJE5QV-5_TA
Project CLASH 24 - Weekly Philadelphia Project M Tournament	Video:hrrX6HMgnTk	Channel:UC5WNBHwgluAwWJE5QV-5_TA
The True King - Project M Regional Atl North Tournament	Video:S9m8B4aPi7o	Channel:UC5WNBHwgluAwWJE5QV-5_TA
The True King - Project M Regional Atl North Tournament	Video:LpduB1hTlEc	Channel:UC5WNBHwgluAwWJE5QV-5_TA
Project M - Vari (Mario) vs Emukiller (Mewtwo) - PC 18 Grand Finals	Video:on2a564UeMQ	Channel:UC5WNBHwgluAwWJE5QV-5_TA
Project M - Vari (Fox) vs Panties (Pit) - PC 18 Losers Finals	Video:KMYz8_g1wjU	Channel:UC5WNBHwgluAwWJE5QV-5_TA
Project M - Chibo (Samus) vs Panties (Captain Falcon) - PC 18 Losers	Video:jJuU9hr2PFY	Channel:UC5WNBHwgluAwWJE5QV-5_TA
Project M - Nevergreen (Captain Falcon) vs Panties (Captain Falcon) - PC 18 Losers	Video:QXz63RppxoA	Channel:UC5WNBHwgluAwWJE5QV-5_TA
Project M - Chibo (Samus) vs Woody (Ness) - PC 18 Losers	Video:SMaYflLs7No	Channel:UC5WNBHwgluAwWJE5QV-5_TA
Project M - Vari (Mario) vs Emukiller (Mewtwo) - PC 18 Winners Finals	Video:HxCDzDx7DNc	Channel:UC5WNBHwgluAwWJE5QV-5_TA
Project M - Vari (Mario) vs Woody (Ness) - PC 18 Winners	Video:vPS35p74zKI	Channel:UC5WNBHwgluAwWJE5QV-5_TA
Project M - Emukiller (Meta Knight) vs Panties (Pit) - PC 18 Winners	Video:zvXe6SSpqiE	Channel:UC5WNBHwgluAwWJE5QV-5_TA
Project M - Vari (Mario) vs GudBJ (Bowser) - PC 18 Winners	Video:c4cxyT06wAw	Channel:UC5WNBHwgluAwWJE5QV-5_TA
Project M - Chibo (Samus) vs Panties (Captain Falcon) - PC 18 Winners	Video:uMAR-ZLKfsE	Channel:UC5WNBHwgluAwWJE5QV-5_TA
Project M - Woody (Ness) vs Nevergreen (Captain Falcon) - PC 18 Winners	Video:qo01U0NGWk0	Channel:UC5WNBHwgluAwWJE5QV-5_TA
Project M - Vari (Diddy Kong) vs Cheese (Marth) - PC 18 Winners	Video:UH4ZKeJ9O3s	Channel:UC5WNBHwgluAwWJE5QV-5_TA
Project M - Chibo (Samus) vs Shrub (Zelda) - PC 18 Winners	Video:ujkojufGLy0	Channel:UC5WNBHwgluAwWJE5QV-5_TA
Philadelphia Project M Circuit Announcement	Video:ERXQShua0HQ	Channel:UC5WNBHwgluAwWJE5QV-5_TA
Project M - Aidan (Zero Suit Samus) vs Panties (Captain Falcon) - PC 17 Grand Finals	Video:UxDXS7H5ZmQ	Channel:UC5WNBHwgluAwWJE5QV-5_TA
Project M - Chibo (Samus) vs Panties (Captain Falcon) - PC 17 Losers Finals	Video:tR_G9Y8nwD4	Channel:UC5WNBHwgluAwWJE5QV-5_TA
Project M - Spaceman (Captain Falcon) vs Panties (Captain Falcon) - PC 17 Losers	Video:v6t-hTMfFXo	Channel:UC5WNBHwgluAwWJE5QV-5_TA
Project M - Chibo (Ganondorf) vs Aidan (Ganondorf) - PC 17 Winners Finals	Video:fwmjPvFTQHM	Channel:UC5WNBHwgluAwWJE5QV-5_TA
Project M - Chibo (Samus) vs Sans (Ganondorf) - PC 17 Winners	Video:Wup5s9jIu9k	Channel:UC5WNBHwgluAwWJE5QV-5_TA
Project M - Chibo (Samus) vs Baked (Ike) - PC 17 Winners	Video:bwdWl4iWMGg	Channel:UC5WNBHwgluAwWJE5QV-5_TA
Project M - Nyani (Ivysaur) vs Aidan (Zero Suit Samus) - PC 17 Winners	Video:0L3lavryL08	Channel:UC5WNBHwgluAwWJE5QV-5_TA
Project M - Panties (Captain Falcon) vs Aidan (Zero Suit Samus) - PC 17 Winners	Video:8q0NhWNQvJE	Channel:UC5WNBHwgluAwWJE5QV-5_TA
Project M - 10TC (Mr. Game and Watch) vs Nyani (Ivysaur) - PC 17 Winners	Video:wDleYNv7C34	Channel:UC5WNBHwgluAwWJE5QV-5_TA
Super Project CLASH 01 - Philadelphia Monthly Project M Tournament	Video:hTgJOhdW6dY	Channel:UC5WNBHwgluAwWJE5QV-5_TA
Nintendo Switch - Sonic Mania at New York Premiere Event - Studiopolis Zone Gameplay	Video:r8P7AEAGaNk	Channel:UC5WNBHwgluAwWJE5QV-5_TA
Nintendo Switch - Zelda Breath of the Wild Gameplay at New York Premiere Event	Video:Qb88wwB7vvs	Channel:UC5WNBHwgluAwWJE5QV-5_TA
Nintendo Switch - ARMS Gameplay Featuring NRG Nairo	Video:HOxxh5Gm3ns	Channel:UC5WNBHwgluAwWJE5QV-5_TA
Project CLASH 23 - Philadelphia Weekly Project M Tournament	Video:f0uMnE5MtKY	Channel:UC5WNBHwgluAwWJE5QV-5_TA
Project M Olympus Top 8 Highlights	Video:p2F564V6idw	Channel:UC5WNBHwgluAwWJE5QV-5_TA
Watch Project CLASH Live Every Thursday @ 7pm [Project M Tournament]	Video:FPvOiepEKuE	Channel:UC5WNBHwgluAwWJE5QV-5_TA
Project CLASH 22 - Philadelphia Weekly Project M Tournament	Video:MEaE42F5m5o	Channel:UC5WNBHwgluAwWJE5QV-5_TA
Project M - Aidan (ZSS) vs Fedrias (Squirtle) - PC 16 Grand Finals	Video:lPwS5MhHYAI	Channel:UC5WNBHwgluAwWJE5QV-5_TA
Project M - Chibo (Samus) vs Fedrias (Squirtle) - PC 16 Losers Finals	Video:LrnTwllYOVM	Channel:UC5WNBHwgluAwWJE5QV-5_TA
Project M - Chibo (Samus) vs Phire (Roy) - PC 16 Losers	Video:CsXUE-4oA2E	Channel:UC5WNBHwgluAwWJE5QV-5_TA
Project M - Aidan (Marth/ZSS) vs Fedrias (Squirtle) - PC 16 Winners Finals	Video:VDv48mtGIv8	Channel:UC5WNBHwgluAwWJE5QV-5_TA
Project M - Chibo (Samus) vs Woody (Ness) - PC 16 Losers	Video:b0ZfR7hdteA	Channel:UC5WNBHwgluAwWJE5QV-5_TA
Project M - Vari (Fox) vs Phire (Roy) - PC 16 Winners	Video:sipL8-zGi88	Channel:UC5WNBHwgluAwWJE5QV-5_TA
Project M - Woody (Ness) vs Fedrias (Squirtle) - PC 16 Winners	Video:6wh4sWDBZ4Y	Channel:UC5WNBHwgluAwWJE5QV-5_TA
Project M - Aidan (ZSS) vs Phire (Roy) - PC 16 Winners	Video:jBitwsSJDMY	Channel:UC5WNBHwgluAwWJE5QV-5_TA
Project M - Woody (Ness) vs GudBJ (Bowser) - PC 16 Winners	Video:UEiMIedEnI8	Channel:UC5WNBHwgluAwWJE5QV-5_TA
Project M - Phire (Roy) vs Chibo (Samus) - PC 16 Winners	Video:9p5sVh5IpqQ	Channel:UC5WNBHwgluAwWJE5QV-5_TA
Project M - Dusty (Falcon) vs Aidan (Marth) - PC 15 Grand Finals	Video:7szsRN1IF-4	Channel:UC5WNBHwgluAwWJE5QV-5_TA
Project M - Dusty (Marth) vs Tunechi (Snake) - PC 15 Losers Finals	Video:he9L7MCtBS0	Channel:UC5WNBHwgluAwWJE5QV-5_TA
Project M - Griffith (Fox) vs Tunechi (Snake) - PC 15 Losers	Video:Wo1zXQ2r-wg	Channel:UC5WNBHwgluAwWJE5QV-5_TA
Project M - Dusty (Falcon/Roy) vs Aidan (Marth) - PC 15 Winners Finals	Video:mP7xmXH2cww	Channel:UC5WNBHwgluAwWJE5QV-5_TA
Project M - Dusty (Marth) vs Tunechi (Snake) - PC 15 Winners	Video:NZwXnSMPfro	Channel:UC5WNBHwgluAwWJE5QV-5_TA
Project M - Griffith (Fox) vs Aidan (Marth) - PC 15 Winners	Video:NGtzDSCN3s4	Channel:UC5WNBHwgluAwWJE5QV-5_TA
Project M - Tunechi (Snake) vs Vari (Mario/Falco) - PC 15 Winners	Video:ebbzDc5ll2A	Channel:UC5WNBHwgluAwWJE5QV-5_TA
Project M - Dotcom (Olimar/Wario) vs Griffith (Fox) - PC 15 Winners	Video:-BJ9KFSLYRg	Channel:UC5WNBHwgluAwWJE5QV-5_TA
Project M - Aidan (Marth) vs GudBJ (Bowser) - PC 15 Winners	Video:tD9etJvmIzs	Channel:UC5WNBHwgluAwWJE5QV-5_TA
Project M - Woody (Ness) vs Phire (Roy) - PC 15 Winners	Video:kQOtFBX0vs4	Channel:UC5WNBHwgluAwWJE5QV-5_TA
Project M - GudBJ (Bowser) vs Chibo (Samus) - PC 15 Winners	Video:HGNBNGiMdLc	Channel:UC5WNBHwgluAwWJE5QV-5_TA
Smash 4 Wii U - Spirunk (Yoshi) vs Vash (Lucina/Marth) - S&C 18 Grand Finals	Video:Pp5qSJhysds	Channel:UC5WNBHwgluAwWJE5QV-5_TA
Smash 4 Wii U - Sparky (Charizard/Pikachu) vs Vash (Marth) - S&C 18 Losers Finals	Video:X8bQETr1dcs	Channel:UC5WNBHwgluAwWJE5QV-5_TA
Smash 4 Wii U - Sparky (Charizard) vs Jtart (Ryu/Fox) - S&C 18 Losers	Video:uSASMEvwxmo	Channel:UC5WNBHwgluAwWJE5QV-5_TA
Smash 4 Wii U - Vash (Marth) vs Spirunk (Yoshi) - S&C 18 Winners Finals	Video:lVjzg-V4Gp4	Channel:UC5WNBHwgluAwWJE5QV-5_TA
Smash 4 Wii U - Vash (Marth) vs Sparky (Pikachu) - S&C 18 Winners	Video:dQyf-y9hvvY	Channel:UC5WNBHwgluAwWJE5QV-5_TA
Smash 4 Wii U - Chibo (Mii Gunner) vs Spirunk (Yoshi) - S&C 18 Winners	Video:5rEb65UT6dk	Channel:UC5WNBHwgluAwWJE5QV-5_TA
Smash 4 Wii U - Chibo (Mii Gunner) vs Bhee (Roy/Fox) - S&C 18 Winners	Video:hEAB2dt73NM	Channel:UC5WNBHwgluAwWJE5QV-5_TA
Project CLASH 21 - Philadelphia Weekly Project M Tournament	Video:0mo0s6RY6yI	Channel:UC5WNBHwgluAwWJE5QV-5_TA
Project M - Emukiller (Meta Knight) vs DVD (Toon Link) - PC 14 Grand Finals	Video:j7f1mqF6cRU	Channel:UC5WNBHwgluAwWJE5QV-5_TA
Project M - Emukiller (Meta Knight) vs Jason Waterfalls (ZSS) - PC 14 Losers Finals	Video:36ai_4fxFCs	Channel:UC5WNBHwgluAwWJE5QV-5_TA
Project M - Emukiller (Meta Knight) vs Aion (Sonic) - PC 14 Losers	Video:xs_EDOSvADk	Channel:UC5WNBHwgluAwWJE5QV-5_TA
Project M - Emukiller (Meta Knight) vs Envy (Ike) - PC 14 Losers	Video:3VSFaqh9b2Y	Channel:UC5WNBHwgluAwWJE5QV-5_TA
Project M - Emukiller (Meta Knight) vs Aidan (ZSS) - PC 14 Losers	Video:02nfJ-yBlV8	Channel:UC5WNBHwgluAwWJE5QV-5_TA
Project M - DVD (Toon Link) vs Jason Waterfalls (ZSS) - PC 14 Winners Finals	Video:2QyLSdRuWDQ	Channel:UC5WNBHwgluAwWJE5QV-5_TA
Project M - Envy (Ike) vs Jason Waterfalls (ZSS) - PC 14 Winners	Video:Fx00vww0Nmc	Channel:UC5WNBHwgluAwWJE5QV-5_TA
Project M - Professor Pro (Snake) vs DVD (Toon Link) - PC 14 Winners	Video:mlMiM3diurg	Channel:UC5WNBHwgluAwWJE5QV-5_TA
Project M - Envy (Ike) vs BaconPancakes (Diddy) - PC 14 Winners	Video:o5QopSViTmo	Channel:UC5WNBHwgluAwWJE5QV-5_TA
Project M - DVD (Toon Link) vs Aidan (ZSS) - PC 14 Winners	Video:zOQw9gxT49M	Channel:UC5WNBHwgluAwWJE5QV-5_TA
Project M - Switch (Wolf) vs Professor Pro (Snake) - PC 14 Winners	Video:IHXbjgrCm74	Channel:UC5WNBHwgluAwWJE5QV-5_TA
Project M - Dusty (Marth) vs Jason Waterfalls (ZSS) - PC 14 Winners	Video:B1JKqZkBWT0	Channel:UC5WNBHwgluAwWJE5QV-5_TA
Project M - Envy (Ike) vs Lucky (Fox) - PC 14 Winners	Video:Dc27T3N-G_Y	Channel:UC5WNBHwgluAwWJE5QV-5_TA
Project M - Dotcom (Olimar) vs Professor Pro (Snake) - PC 14 Winners	Video:l_bjCmWDNCE	Channel:UC5WNBHwgluAwWJE5QV-5_TA
Project M - Venom (Cpt Falcon) vs Aidan (ZSS) - PC 14 Winners	Video:veMIgR7bBwU	Channel:UC5WNBHwgluAwWJE5QV-5_TA
Project M - Tealz (Meta Knight) vs BaconPancakes (Diddy) - PC 14 Winners	Video:iWTVPIqQy2M	Channel:UC5WNBHwgluAwWJE5QV-5_TA
Project M - Jason Waterfalls (ZSS) vs Kingtoon (Charizard) - PC 14 Winners	Video:REj1Jx9d0mk	Channel:UC5WNBHwgluAwWJE5QV-5_TA
Project M - Venom (Falcon) vs Deff (Bowser) - PC 14 Winners	Video:-7co4znz0gk	Channel:UC5WNBHwgluAwWJE5QV-5_TA
Project M - Aion (Sonic) vs GL (Meta Knight) - PC 14 Winners	Video:DKuIKs6oVF0	Channel:UC5WNBHwgluAwWJE5QV-5_TA
Project M - BaconPancakes (Diddy) vs Gio (ZSS) - PC 14 Winners	Video:ccPIH0qIdd0	Channel:UC5WNBHwgluAwWJE5QV-5_TA
Project M - Salem (Ganondorf/Zelda) vs Emukiller (Meta Knight) - PC 14 Winners	Video:zMtoC0hwfyY	Channel:UC5WNBHwgluAwWJE5QV-5_TA
Project M - Odds (Sonic) vs Quaza (Ike) - PC 14 Winners	Video:9IQMMccoCQU	Channel:UC5WNBHwgluAwWJE5QV-5_TA
Project M - Reno (Ike/Fox) vs Stango (Meta Knight) - PC 14 Winners	Video:2wF4ltzpUP8	Channel:UC5WNBHwgluAwWJE5QV-5_TA
Project M - Vari (Mario) vs Kingtoon (Charizard) - PC 14 Winners	Video:haxK9eOsXk4	Channel:UC5WNBHwgluAwWJE5QV-5_TA
Project M - Aidan (ZSS) vs Alcapwned (Sheik) - PC 14 Winners	Video:NRATKBZ0DLA	Channel:UC5WNBHwgluAwWJE5QV-5_TA
Project M - Maximum Leech (Roy) vs Kingtoon (Charizard) - PC 14 Winners	Video:IvFL3nzbSiw	Channel:UC5WNBHwgluAwWJE5QV-5_TA
Project M - Phillyrider (Sheik) vs Tunechi (Snake) - PC 14 Winners	Video:Qaz29vgPJWI	Channel:UC5WNBHwgluAwWJE5QV-5_TA
Project M - Salem (Zelda/Ganondorf) vs Woody (Ness) - PC 14 Winners	Video:rrb4T4xUgtY	Channel:UC5WNBHwgluAwWJE5QV-5_TA
Project CLASH 20 - Philadelphia Weekly Project M Tournament	Video:LLlgsom6WXk	Channel:UC5WNBHwgluAwWJE5QV-5_TA
Olympus - Venom (Captain Falcon) vs StereoKiDD (Ness) - PM Pools - Project M	Video:zbHdctSB2tM	Channel:UC5WNBHwgluAwWJE5QV-5_TA
Olympus - ThundeRzReiGN (Donkey Kong) vs Switch (Wolf) - PM Pools - Project M	Video:Be_iYuBcYK0	Channel:UC5WNBHwgluAwWJE5QV-5_TA
Olympus - Dirtboy (Squirtle) vs DVD (Toon Link) - PM Pools - Project M	Video:gjcbsOByCQU	Channel:UC5WNBHwgluAwWJE5QV-5_TA
Olympus - Zhime (Zelda) vs Sosa (Wario) - PM Pools - Project M	Video:yqttc5B9K_A	Channel:UC5WNBHwgluAwWJE5QV-5_TA
Olympus - Kycse (Charizard) vs Anther (Pikachu) - PM Pools - Project M	Video:ySgnRyLwKb4	Channel:UC5WNBHwgluAwWJE5QV-5_TA
Olympus - DVD (Toon Link) vs Aidan (Zero Suit Samus) - PM Pools - Project M	Video:xnPRkHZ22Oo	Channel:UC5WNBHwgluAwWJE5QV-5_TA
Olympus - Switch (Wolf) vs Jason Waterfalls (Zero Suit Samus) - PM Pools - Project M	Video:wiiOLdQG4mA	Channel:UC5WNBHwgluAwWJE5QV-5_TA
Olympus - Strong Bad (Wario) vs Flipp (Snake) - PM Pools - Project M	Video:u8v-FkK9LWM	Channel:UC5WNBHwgluAwWJE5QV-5_TA
Olympus - DVD (Toon Link) vs Drephen (Sheik) - PM Pools - Project M	Video:_W0Z9YZgyyg	Channel:UC5WNBHwgluAwWJE5QV-5_TA
Olympus - Aion (Sonic) vs Envy (Ike) - PM Pools - Project M	Video:sJElT8ZNHOU	Channel:UC5WNBHwgluAwWJE5QV-5_TA
Olympus - StrongBad (Wario) vs SonED (Cpt Falcon) - PM Pools - Project M	Video:EtyQor847tM	Channel:UC5WNBHwgluAwWJE5QV-5_TA
Olympus - Silver + Darc vs Dakpo + Lunchables - PM Winners Semis - Project M	Video:0OtM18x4GYU	Channel:UC5WNBHwgluAwWJE5QV-5_TA
Olympus - Junebug + Malachi vs Sosa + Jose V - PM Winners Semis - Project M	Video:kEsMVyW7_co	Channel:UC5WNBHwgluAwWJE5QV-5_TA
Olympus - Junebug + Malachi vs Envy + DVD - PM Winners - Project M	Video:JZPo3kEum6s	Channel:UC5WNBHwgluAwWJE5QV-5_TA
Olympus - Silver + Darc vs Flipp + Kycse - PM Winners - Project M	Video:TILFDqd3Sfw	Channel:UC5WNBHwgluAwWJE5QV-5_TA
Olympus - Sosa + Jose V vs burntsocks + Sneez - PM Winners - Project M	Video:YgdgKz5Cer8	Channel:UC5WNBHwgluAwWJE5QV-5_TA
Olympus - Sosa + Jose V vs DJ Nintendo + Luck - PM Winners - Project M	Video:heW-OBJ8-D4	Channel:UC5WNBHwgluAwWJE5QV-5_TA
Olympus - Sylarius + Odds vs Aero + Venom - PM Winners - Project M	Video:ywazTe4DYIo	Channel:UC5WNBHwgluAwWJE5QV-5_TA
Olympus - ThundeRzReiGN + XYK vs DJ Nintendo + Luck - PM Winners - Project M	Video:Jn4I_ZdG9Us	Channel:UC5WNBHwgluAwWJE5QV-5_TA
Olympus - Lunchables + Dakpo vs Gooley + Mr. Watch & Learn - PM Winners - Project M	Video:cpD31m6kyvY	Channel:UC5WNBHwgluAwWJE5QV-5_TA
This is what happens when you host a Smash tournament on Halloween	Video:BsZExbrSqUM	Channel:UC5WNBHwgluAwWJE5QV-5_TA
Olympus - BaconPancakes + Goode vs Tr0y + American Bowser - PM Winners - Project M	Video:2KWuHTr_8to	Channel:UC5WNBHwgluAwWJE5QV-5_TA
Olympus - Lucky + Professor Pro vs Vari + Wax - PM Winners - Project M	Video:wJg3m0X_cY0	Channel:UC5WNBHwgluAwWJE5QV-5_TA
Olympus - Darc + Silver vs Satoshi + SonED - PM Winners - Project M	Video:rtgy95fKSHY	Channel:UC5WNBHwgluAwWJE5QV-5_TA
Olympus - Jaden + Darkblues vs Nevergreen + Tacocat - PM Winners - Project M	Video:KVdYnkF-lZY	Channel:UC5WNBHwgluAwWJE5QV-5_TA
Olympus - Twisty (Wario) vs Jose V (Ness) - PM Pools - Project M	Video:w1Q7g7jJJaE	Channel:UC5WNBHwgluAwWJE5QV-5_TA
Olympus - Jaden (Zelda) vs Redd (Fox) - PM Pools - Project M	Video:jpY57jJaO1M	Channel:UC5WNBHwgluAwWJE5QV-5_TA
Olympus - Aidan (Zero Suit Samus) vs Aero (Diddy Kong) - PM Pools - Project M	Video:cvvj7obb1Zg	Channel:UC5WNBHwgluAwWJE5QV-5_TA
Olympus - StereoKiDD (Ness) vs burntsocks (Yoshi) - PM Pools - Project M	Video:7f0nqaIlDGg	Channel:UC5WNBHwgluAwWJE5QV-5_TA
Olympus - Odds (Bowser) vs Shiny Zubat (Yoshi) - PM Pools - Project M	Video:pMsS9InAKdw	Channel:UC5WNBHwgluAwWJE5QV-5_TA
Olympus - Anther (Pikachu) vs Aion (Sonic) - PM Pools - Project M	Video:MU3lyxcTGnA	Channel:UC5WNBHwgluAwWJE5QV-5_TA
Olympus - Tealz (Meta Knight) vs Gallo (Mario) - PM Pools - Project M	Video:9mmiSeizR3E	Channel:UC5WNBHwgluAwWJE5QV-5_TA
Olympus - Jason Waterfalls (Zero Suit Samus) vs Aki (Ness) - PM Pools - Project M	Video:iDBJ42a_348	Channel:UC5WNBHwgluAwWJE5QV-5_TA
Olympus - Venom (Captain Falcon) vs Milkman (Fox) - PM Pools - Project M	Video:A2v0rQ5obhs	Channel:UC5WNBHwgluAwWJE5QV-5_TA
Olympus - Envy (Ike) vs Filthy Casual (Captain Falcon) - PM Pools - Project M	Video:7Op1CsTbPts	Channel:UC5WNBHwgluAwWJE5QV-5_TA
Olympus - Emukiller (Mewtwo) vs Stoks (Mario) - PM Pools - Project M	Video:7h4Zwpz2nGU	Channel:UC5WNBHwgluAwWJE5QV-5_TA
Olympus - GuruKid (Wario) vs BaconPancakes (Fox) - PM Pools - Project M	Video:tRbgDC2-ZC0	Channel:UC5WNBHwgluAwWJE5QV-5_TA
Olympus - Gooley (Sonic) vs Darc (Captain Falcon / Samus) - PM Pools - Project M	Video:lH-k1qhIgrY	Channel:UC5WNBHwgluAwWJE5QV-5_TA
Olympus - Sylarius (Ike) vs Luck (Diddy Kong)  - PM Pools - Project M	Video:tTmLWtumhCU	Channel:UC5WNBHwgluAwWJE5QV-5_TA
Olympus - Lucky (Fox) vs Switch (Wolf) - PM Pools - Project M	Video:LUZHzMZPaf4	Channel:UC5WNBHwgluAwWJE5QV-5_TA
Olympus - DVD (Toon Link) vs Reslived (Ness) - PM Pools - Project M	Video:F1OwREjtups	Channel:UC5WNBHwgluAwWJE5QV-5_TA
Olympus - Kycse (Charizard) vs Strong Bad (Wario) - PM Pools - Project M	Video:fKtD9iH8VHQ	Channel:UC5WNBHwgluAwWJE5QV-5_TA
Olympus - Dirtboy (Squirtle) vs Dusty (Marth) - PM Pools - Project M	Video:bSUjsTzLeEk	Channel:UC5WNBHwgluAwWJE5QV-5_TA
Olympus - Professor Pro (Snake) vs XYK (Luigi) - PM Pools - Project M	Video:0Uz5ucoWjx4	Channel:UC5WNBHwgluAwWJE5QV-5_TA
Olympus - ThundeRzReiGN (Captain Falcon) vs Mr. Watch & Learn (GaW) - PM Pools - Project M	Video:y9FbfAWJGNM	Channel:UC5WNBHwgluAwWJE5QV-5_TA
Olympus - SonED (Captain Falcon) vs Malachi (Peach) - PM Pools - Project M	Video:Da1Taa2BUFI	Channel:UC5WNBHwgluAwWJE5QV-5_TA
Olympus - MorKs (Wario) vs Flipp (Snake) - PM Pools - Project M	Video:FQoTyubCZiA	Channel:UC5WNBHwgluAwWJE5QV-5_TA
Olympus - Hyperflame (Lucas) vs Fearless (Lucario) - PM Pools - Project M	Video:XrxUSJ4VMRQ	Channel:UC5WNBHwgluAwWJE5QV-5_TA
Olympus - Junebug (Diddy Kong) vs Flarp (Luigi) - PM Pools - Project M	Video:X5csxU_2hN0	Channel:UC5WNBHwgluAwWJE5QV-5_TA
Olympus - Lunchables (Marth) vs Sneez (ROB) - PM Pools - Project M	Video:14Nr_lmgsI4	Channel:UC5WNBHwgluAwWJE5QV-5_TA
Olympus - Sosa (Wario) vs Dotcom (Olimar) - PM Pools - Project M	Video:DR_zC1yQX6w	Channel:UC5WNBHwgluAwWJE5QV-5_TA
Revival of Brawl - Interview with V115 - SSBB - Smash Brawl	Video:K2E_lyThTbA	Channel:UC5WNBHwgluAwWJE5QV-5_TA
Revival of Brawl - Interview with Salem - SSBB - Smash Brawl	Video:8qWD7Cz_8HA	Channel:UC5WNBHwgluAwWJE5QV-5_TA
Revival of Brawl - Salem (ZSS) vs V115 (ZSS) - SSBB Grand Finals - Smash Brawl	Video:Rk4J6fmDfx8	Channel:UC5WNBHwgluAwWJE5QV-5_TA
Revival of Brawl - Salem (Zero Suit Samus) vs MikeRay (Snake) - SSBB Losers Finals - Smash Brawl	Video:xUHpzwHms34	Channel:UC5WNBHwgluAwWJE5QV-5_TA
Revival of Brawl - MikeRay (Snake) vs Chibo (ROB) - SSBB Losers Semis - Smash Brawl	Video:_2fvDJLjR2M	Channel:UC5WNBHwgluAwWJE5QV-5_TA
Revival of Brawl - V115 (ZSS) vs Salem (ZSS) - SSBB Winners Finals - Smash Brawl	Video:e-y-rJ73D5o	Channel:UC5WNBHwgluAwWJE5QV-5_TA
Revival of Brawl - MikeRay (Snake) vs Hinkage (Kirby) - SSBB Losers Quarters - Smash Brawl	Video:ZgXdLG4pZg8	Channel:UC5WNBHwgluAwWJE5QV-5_TA
Revival of Brawl - Chibo (ROB) vs Vincessant (Falco) - SSBB Losers Quarters - Smash Brawl	Video:dweQnnmivIM	Channel:UC5WNBHwgluAwWJE5QV-5_TA
Revival of Brawl - Hinkage (Meta Knight) vs Figy (Snake) - SSBB Losers Top 8 - Smash Brawl	Video:mJCLcpv2S7w	Channel:UC5WNBHwgluAwWJE5QV-5_TA
Revival of Brawl - Ish (Wolf) vs Vincessant (Falco)  - SSBB Losers Top 8 - Smash Brawl	Video:OpE--Lw83sA	Channel:UC5WNBHwgluAwWJE5QV-5_TA
Revival of Brawl - Salem (Zero Suit Samus) vs MikeRay (Snake) - SSBB Winners Semis - Smash Brawl	Video:OL9B1GyQLa4	Channel:UC5WNBHwgluAwWJE5QV-5_TA
Revival of Brawl - V115 (Zero Suit Samus) vs Chibo (ROB) - SSBB Winners Semis - Smash Brawl	Video:foXKC0l1RAk	Channel:UC5WNBHwgluAwWJE5QV-5_TA
Revival of Brawl - Ish (Wolf) vs MikeRay (Snake) - SSBB Winners - Smash Brawl	Video:Cc42GURVu2I	Channel:UC5WNBHwgluAwWJE5QV-5_TA
Revival of Brawl - Chibo (ROB) vs Hinkage (Meta Knight / Snake) - SSBB Winners - Smash Brawl	Video:-KddNRy3aVQ	Channel:UC5WNBHwgluAwWJE5QV-5_TA
Revival of Brawl - Salem (Zero Suit Samus) vs Vincessant (Falco) - SSBB Winners - Smash Brawl	Video:a7YqECsZtJQ	Channel:UC5WNBHwgluAwWJE5QV-5_TA
Revival of Brawl - MikeRay (Snake) vs Mugutu (Falco) - SSBB Winners - Smash Brawl	Video:tLgOoyHN9r0	Channel:UC5WNBHwgluAwWJE5QV-5_TA
Revival of Brawl - Chibo (ROB) vs Ish (Wolf) - SSBB Mid Tiers Grand Finals - Smash Brawl	Video:PDwu1zGPR_E	Channel:UC5WNBHwgluAwWJE5QV-5_TA
Revival of Brawl - Chibo (ROB) vs Salem (Ganon / Zelda) - SSBB Mid Tiers Losers Finals - Smash Brawl	Video:n6-p0os0X94	Channel:UC5WNBHwgluAwWJE5QV-5_TA
Revival of Brawl - Chibo (ROB) vs V115 (Ness) - SSBB Mid Tiers Losers Semis - Smash Brawl	Video:Nowqwfv3Obw	Channel:UC5WNBHwgluAwWJE5QV-5_TA
Revival of Brawl - Salem (Ganondorf) vs Ish (Wolf) - SSBB Mid Tiers Winners Finals - Smash Brawl	Video:1e3iZKulCmE	Channel:UC5WNBHwgluAwWJE5QV-5_TA
Revival of Brawl - Ish (Wolf) vs V115 (Ness) - SSBB Mid Tiers Winners - Smash Brawl	Video:xH2Y2RaMmQI	Channel:UC5WNBHwgluAwWJE5QV-5_TA
Revival of Brawl - Chibo (ROB) vs Salem (Ganondorf) - SSBB Mid Tiers Winners - Smash Brawl	Video:__ViX7saONo	Channel:UC5WNBHwgluAwWJE5QV-5_TA
Revival of Brawl - Ish (Wolf) vs Jedisquid (ROB) - SSBB Mid Tiers Winners - Smash Brawl	Video:GwJbXTYSMCo	Channel:UC5WNBHwgluAwWJE5QV-5_TA
Revival of Brawl - Figy (Captain Falcon) vs V115 (Ness) - SSBB Mid Tiers Winners - Smash Brawl	Video:5olywB7nqbE	Channel:UC5WNBHwgluAwWJE5QV-5_TA
Revival of Brawl - Salem (Ganondorf) vs Low Tier Hero (Mario) - SSBB Mid Tiers Winners - Smash Brawl	Video:MFT8TW3PhYg	Channel:UC5WNBHwgluAwWJE5QV-5_TA
Revival of Brawl - Chibo (ROB) vs Immortal Corrupter 82 (ROB) - SSBB Mid Tiers Winners - Smash Brawl	Video:YDAJW4x3u74	Channel:UC5WNBHwgluAwWJE5QV-5_TA
Revival of Brawl - MikeRay + Hinkage vs Ish + Eazy - SSBB - Smash Brawl	Video:eJohssuWSwg	Channel:UC5WNBHwgluAwWJE5QV-5_TA
Revival of Brawl - Salem + Vincessant vs V115 + Pidgezero_one - SSBB - Smash Brawl	Video:mvPMkkCdVOk	Channel:UC5WNBHwgluAwWJE5QV-5_TA
Revival of Brawl - MikeRay + Hinkage vs V115 + Pidgezero_one - SSBB - Smash Brawl	Video:ytvn-9Sdbwo	Channel:UC5WNBHwgluAwWJE5QV-5_TA
Revival of Brawl - Ish + Eazy vs Salem + Vincessant - SSBB - Smash Brawl	Video:1d-Zqpct5fk	Channel:UC5WNBHwgluAwWJE5QV-5_TA
Revival of Brawl - MikeRay + Hinkage vs Salem + Vincessant - SSBB - Smash Brawl	Video:L4SvCDVT3ps	Channel:UC5WNBHwgluAwWJE5QV-5_TA
Revival of Brawl - V115 + Pidgezero_one vs Ish + Eazy - SSBB - Smash Brawl	Video:xOcy1SNNd3w	Channel:UC5WNBHwgluAwWJE5QV-5_TA
Olympus - Lucky + Reno vs Druggedfox + Slox - SSBM Grand Finals - Smash Melee	Video:IYUpdIEpI0k	Channel:UC5WNBHwgluAwWJE5QV-5_TA
Olympus - DJ Nintendo + The Moon vs Druggedfox + Slox - SSBM Losers Finals - Smash Melee	Video:se06py0eWBc	Channel:UC5WNBHwgluAwWJE5QV-5_TA
Olympus - Druggedfox + Slox vs Professor Pro + Mike Haze - SSBM Losers Semis - Smash Melee	Video:DE2zyHEVRVo	Channel:UC5WNBHwgluAwWJE5QV-5_TA
Olympus - 6WX + Tweek vs Hames + The Great Gonzales - SSB4 Grand Finals - Smash Wii U	Video:hbfFF-k7taU	Channel:UC5WNBHwgluAwWJE5QV-5_TA
Olympus - James + The Great Gonzales vs Anti + Larry Lurr - SSB4 Losers Finals - Smash Wii U	Video:Hyr2HTYu_NU	Channel:UC5WNBHwgluAwWJE5QV-5_TA
Olympus - Salem + Fatality vs James + The Great Gonzales - SSB4 Losers Semis - Smash Wii U	Video:YEIa9ljpBYc	Channel:UC5WNBHwgluAwWJE5QV-5_TA
Olympus - Larry Lurr + Anti vs 6WX + Tweek - SSB4 Winners Finals - Smash Wii U	Video:AmJan5kFZEc	Channel:UC5WNBHwgluAwWJE5QV-5_TA
Olympus - K9 + Dakpo vs Salem + Fatality - SSB4 Losers - Smash Wii U	Video:vlXquDDlri0	Channel:UC5WNBHwgluAwWJE5QV-5_TA
Olympus - K9 + Dakpo vs Angel Cortes + Nurse Debby - SSB4 Losers - Smash Wii U	Video:4e82SqWgoD0	Channel:UC5WNBHwgluAwWJE5QV-5_TA
Olympus - The Moon (Marth) vs Hugs (Samus) - SSBM Winners - Smash Melee	Video:wB-Kw1KHcEI	Channel:UC5WNBHwgluAwWJE5QV-5_TA
Olympus - Dizzkidboogie (Ice Climbers) vs Professor Pro (Fox) - SSBM Winners - Smash Melee	Video:uEXgOoYY248	Channel:UC5WNBHwgluAwWJE5QV-5_TA
Olympus - Lucky (Fox) vs Slox (Fox) - SSBM Winners - Smash Melee	Video:bUcd8X1BsHE	Channel:UC5WNBHwgluAwWJE5QV-5_TA
Olympus - Druggedfox (Fox) vs MikeHaze (Fox) - SSBM Winners - Smash Melee	Video:fIi6-5od1pY	Channel:UC5WNBHwgluAwWJE5QV-5_TA
Olympus - Redd (Fox) vs The Moon (Marth) - SSBM Winners - Smash Melee	Video:zAFTIhyRLK0	Channel:UC5WNBHwgluAwWJE5QV-5_TA
Olympus - Lucky (Fox) vs Jaden (Sheik) - SSBM Winners - Smash Melee	Video:GIPU6q2iLGM	Channel:UC5WNBHwgluAwWJE5QV-5_TA
Olympus - DJ Nintendo (Pikachu) vs MikeHaze (Fox) - SSBM Winners - Smash Melee	Video:mHLo5wC-m0k	Channel:UC5WNBHwgluAwWJE5QV-5_TA
Olympus - K9 (Sheik) vs Frozen (Corrin) - SSB4 Losers - Smash Wii U	Video:3vSUKxa2KY0	Channel:UC5WNBHwgluAwWJE5QV-5_TA
Olympus - Fatality (Captain Falcon) vs Zoan (Mewtwo) - SSB4 Losers - Smash Wii U	Video:NR5WkI1g83g	Channel:UC5WNBHwgluAwWJE5QV-5_TA
Olympus - Angel Cortez (Diddy Kong) vs Larry Lurr (Fox) - SSB4 Winners - Smash Wii U	Video:JqoDRju7dBc	Channel:UC5WNBHwgluAwWJE5QV-5_TA
Olympus - 6WX (Sonic) vs Salem (Bayonetta) - SSB4 Winners - Smash Wii U	Video:Tsjpz120zao	Channel:UC5WNBHwgluAwWJE5QV-5_TA
Olympus - Fatality (Captain Falcon) vs Tweek (Cloud) - SSB4 Winners - Smash Wii U	Video:rJMKNL_kjaA	Channel:UC5WNBHwgluAwWJE5QV-5_TA
Olympus - 6WX (Sonic) vs Frozen (Mewtwo) - SSB4 Winners - Smash Wii U	Video:KNIMCITcKRI	Channel:UC5WNBHwgluAwWJE5QV-5_TA
Olympus - Angel Cortez (Diddy Kong) vs Zoan (Mewtwo) - SSB4 Winners - Smash Wii U	Video:FxPwKRjMnaU	Channel:UC5WNBHwgluAwWJE5QV-5_TA
Olympus - Larry Lurr (Fox) vs SmashGod (Kirby) - SSB4 Winners - Smash Wii U	Video:uDpHc4eEZto	Channel:UC5WNBHwgluAwWJE5QV-5_TA
Olympus - Bryce (King Dedede) vs Fatality (Captain Falcon) - SSB4 Winners - Smash Wii U	Video:fATKfja_-7k	Channel:UC5WNBHwgluAwWJE5QV-5_TA
Olympus - K9 (Sheik) vs James (Diddy Kong) - SSB4 Winners - Smash Wii U	Video:QD0EdVZ4KEw	Channel:UC5WNBHwgluAwWJE5QV-5_TA
Olympus - Dyla81 (Ryu) vs Vash (Marth) - SSB4 Losers - Smash Wii U	Video:nqr92YT8I7I	Channel:UC5WNBHwgluAwWJE5QV-5_TA
Olympus - Vash (Marth) vs Dakpo (Zero Suit Samus) - SSB4 Winners - Smash Wii U	Video:DWxuHthIQ0Y	Channel:UC5WNBHwgluAwWJE5QV-5_TA
Olympus - Tweek (Cloud) vs Jakal (Sonic) - SSB4 Winners - Smash Wii U	Video:1mn8zBOJoVI	Channel:UC5WNBHwgluAwWJE5QV-5_TA
Olympus - Drephen (Sheik) vs Wenbobular (Fox) - SSBM Pools - Smash Melee	Video:X49dJ1j9CDM	Channel:UC5WNBHwgluAwWJE5QV-5_TA
Olympus - Professor Pro (Fox) vs beejdanger (Jigglypuff) - SSBM Pools - Smash Melee	Video:GTP-wYdI9gs	Channel:UC5WNBHwgluAwWJE5QV-5_TA
Olympus - Druggedfox (Fox) vs JoePagano (Sheik) - SSBM Winners - Smash Melee	Video:1WBnsOuQ_I4	Channel:UC5WNBHwgluAwWJE5QV-5_TA
Olympus - Lucky (Fox) Abso20 (Marth) - SSBM Pools - Smash Melee	Video:ZY3OBEGBTeY	Channel:UC5WNBHwgluAwWJE5QV-5_TA
Olympus - Redd (Fox) vs Atomsk (Jigglypuff) - SSBM Pools - Smash Melee	Video:i7u1g_cx6J4	Channel:UC5WNBHwgluAwWJE5QV-5_TA
Olympus - Darc (Jigglypuff) vs Milkman (Fox) - SSBM Pools - Smash Melee	Video:WfKD9EIRAJ0	Channel:UC5WNBHwgluAwWJE5QV-5_TA
Olympus - Slox (Fox) vs Twisty (Jigglypuff) - SSBM Pools - Smash Melee	Video:kRCKifQg_cw	Channel:UC5WNBHwgluAwWJE5QV-5_TA
Olympus - The Moon (Marth) vs Bubbles (Cpt Falcon) - SSBM Pools - Smash Melee	Video:XUkZMRs8g7w	Channel:UC5WNBHwgluAwWJE5QV-5_TA
Olympus - SmashG0D (Fox) vs CIZ (Marth) - SSBM Pools - Smash Melee	Video:qEywJtfGpBA	Channel:UC5WNBHwgluAwWJE5QV-5_TA
Olympus - Hugs (Samus) vs Kunai (Dr. Mario) - SSBM Pools - Smash Melee	Video:fU_27gF7TkU	Channel:UC5WNBHwgluAwWJE5QV-5_TA
Olympus - Hugs (Samus) vs KD8 (Falco) - SSBM Pools - Smash Melee	Video:Um_GxjpthlQ	Channel:UC5WNBHwgluAwWJE5QV-5_TA
Olympus - G$ (Marth) vs Playtowingamer (Peach) - SSBM Pools - Smash Melee	Video:kw9dZ3cShkc	Channel:UC5WNBHwgluAwWJE5QV-5_TA
Olympus - Mar (Fox) vs Jaden (Peach) - SSBM Pools - Smash Melee	Video:TURN6KPmMN8	Channel:UC5WNBHwgluAwWJE5QV-5_TA
Olympus - Sand (Fox) vs Kunai (Dr. Mario) - SSBM Pools - Smash Melee	Video:fa3E5xeCAuc	Channel:UC5WNBHwgluAwWJE5QV-5_TA
Project CLASH 18 - Philadelphia Weekly Project M Tournament	Video:lKhIWyqioPQ	Channel:UC5WNBHwgluAwWJE5QV-5_TA
0
1
2
3
4
Project CLASH 16 - Philadelphia Weekly Project M Tournament	Video:MI29WibRz7A	Channel:UC5WNBHwgluAwWJE5QV-5_TA
Olympus - Lunchables + Dakpo vs Silver + Darc - PM Grand Finals - Project M	Video:V0xEgKCkp8U	Channel:UC5WNBHwgluAwWJE5QV-5_TA
Olympus - Junebug + Malachi vs Silver + Darc - PM Losers Finals - Project M	Video:m7uiHkJ1L04	Channel:UC5WNBHwgluAwWJE5QV-5_TA
Olympus - Lunchables + Dakpo vs Junebug + Malachi - PM Winners Finals - Project M	Video:fQALSJuPgjg	Channel:UC5WNBHwgluAwWJE5QV-5_TA
Olympus - Silver + Darc vs Jose V + Sosa - PM Losers Semis - Project M	Video:cNPxXErRFHc	Channel:UC5WNBHwgluAwWJE5QV-5_TA
Olympus - Malachi (Peach/Sheik) vs Professor Pro (Snake/Fox) - PM Losers - Project M	Video:-IOHfBsLOM4	Channel:UC5WNBHwgluAwWJE5QV-5_TA
Olympus - Envy (Ike) vs Jose V (Ness) - PM Losers - Project M	Video:HazYyxMdKtI	Channel:UC5WNBHwgluAwWJE5QV-5_TA
Olympus - Emukiller (Mewtwo/Meta Knight) vs Gallo (Mario) - PM Losers - Project M	Video:yRSwVkIMelw	Channel:UC5WNBHwgluAwWJE5QV-5_TA
Olympus - Jaden (Peach) vs Phresh (Ice Climbers) - PM Losers - Project M	Video:bw7_TIPJt9A	Channel:UC5WNBHwgluAwWJE5QV-5_TA
Olympus - Envy (Ike) vs Sneez (ROB) - PM Losers - Project M	Video:9K17UWJfwdA	Channel:UC5WNBHwgluAwWJE5QV-5_TA
Olympus - Emukiller (Meta Knight) vs Venom (Captain Falcon) - PM Losers - Project M	Video:UP-qbHA9HVQ	Channel:UC5WNBHwgluAwWJE5QV-5_TA
Olympus - Aero (Diddy Kong) vs Malachi (Peach) - PM Losers - Project M	Video:wX86-tIRafg	Channel:UC5WNBHwgluAwWJE5QV-5_TA
Olympus - Lunchables (Roy) vs Jose V (Ness) - PM Winners - Project M	Video:1YDH3W9vnjQ	Channel:UC5WNBHwgluAwWJE5QV-5_TA
Olympus - Junebug (Diddy) vs Jaden (Sheik/Peach) - PM Winners - Project M	Video:E8DDqoJfZL0	Channel:UC5WNBHwgluAwWJE5QV-5_TA
Olympus - Sosa (Wario) vs Gallo (Mario) - PM Winners - Project M	Video:viaqZc58_Sk	Channel:UC5WNBHwgluAwWJE5QV-5_TA
Olympus - ThundeRzReiGN (Donkey Kong) vs Professor Pro (Snake) - PM Winners - Project M	Video:RRSbkYzWPyU	Channel:UC5WNBHwgluAwWJE5QV-5_TA
Olympus - Hyperflame (Lucas) vs Gallo (Mario) - PM Winners - Project M	Video:F7Hrwa7cZIA	Channel:UC5WNBHwgluAwWJE5QV-5_TA
Olympus - Venom (Captain Falcon) vs Junebug (Diddy Kong) - PM Winners - Project M	Video:9guUA2mief8	Channel:UC5WNBHwgluAwWJE5QV-5_TA
Olympus - Lunchables (Roy/Marth) vs BaconPancakes (Fox/Diddy) - PM Winners - Project M	Video:BUcT_IpRVQA	Channel:UC5WNBHwgluAwWJE5QV-5_TA
Olympus - dizzkidboogie (Ice Climbers) vs The Moon (Marth) - SSBM Grand Finals - Smash Melee	Video:98sBAc0SmRA	Channel:UC5WNBHwgluAwWJE5QV-5_TA
Olympus - Lucky (Fox) vs The Moon (Marth) - SSBM Losers Finals - Smash Melee	Video:z9YkXqhlkns	Channel:UC5WNBHwgluAwWJE5QV-5_TA
Olympus - The Moon (Marth) vs Professor Pro (Fox) - SSBM Losers Semis - Smash Melee	Video:mj7--Jr5LhM	Channel:UC5WNBHwgluAwWJE5QV-5_TA
Olympus - Lucky (Fox) vs dizzkidboogie (Ice Climbers) - SSBM Winners Finals - Smash Melee	Video:MwZfjtrhl5s	Channel:UC5WNBHwgluAwWJE5QV-5_TA
Olympus - Druggedfox (Fox) vs The Moon (Marth) - SSBM Losers Quarters - Smash Melee	Video:O9_wJnVRbNQ	Channel:UC5WNBHwgluAwWJE5QV-5_TA
Olympus - Mike Haze (Fox) vs Professor Pro (Fox) - SSBM Losers Quarters - Smash Melee	Video:6YS3qc-wluo	Channel:UC5WNBHwgluAwWJE5QV-5_TA
Olympus - Lucky (Fox) vs Mike Haze (Fox) - SSBM Winners Semis - Smash Melee	Video:2itPydJ3o3Y	Channel:UC5WNBHwgluAwWJE5QV-5_TA
Olympus - The Moon (Marth) vs dizzkidboogie (Ice Climbers) - SSBM Winners Semis - Smash Melee	Video:p7bpXugHscU	Channel:UC5WNBHwgluAwWJE5QV-5_TA
Olympus - Hugs (Samus) vs Professor Pro (Fox) - SSBM Losers Top 8 - Smash Melee	Video:QHf-PGi1Cm8	Channel:UC5WNBHwgluAwWJE5QV-5_TA
Olympus - Druggedfox (Fox) vs Slox (Fox) - SSBM Losers Top 8 - Smash Melee	Video:xHscchGVMNw	Channel:UC5WNBHwgluAwWJE5QV-5_TA
Olympus - Salem (Bayonetta) vs Tweek (Cloud) - SSB4 Grand Finals - Smash Wii U	Video:la5RMj7PTgA	Channel:UC5WNBHwgluAwWJE5QV-5_TA
Olympus - Larry Lurr (Donkey Kong/Fox) vs Salem (Bayonetta) - SSB4 Losers Finals - Smash Wii U	Video:C2znNev1jKc	Channel:UC5WNBHwgluAwWJE5QV-5_TA
Olympus - Interview with Chibo	Video:a6lyuhnL3BY	Channel:UC5WNBHwgluAwWJE5QV-5_TA
Olympus - Anti (Mario/Charizard/Cloud) vs Larry Lurr (Fox) - SSB4 Losers Semis - Smash Wii U	Video:C_awxXi31v0	Channel:UC5WNBHwgluAwWJE5QV-5_TA
Olympus - Interview with Gallo	Video:xnAOvKuyvcY	Channel:UC5WNBHwgluAwWJE5QV-5_TA
Olympus - Interview with Lunchables	Video:bXcVbJ0N4BU	Channel:UC5WNBHwgluAwWJE5QV-5_TA
Olympus - Interview with ThundeRzReiGN	Video:8YJ1sD0jN2I	Channel:UC5WNBHwgluAwWJE5QV-5_TA
Olympus - ThundeRzReiGN (Donkey Kong) vs Lunchables (Marth) - PM Grand Finals - Project M	Video:asdWOu86qoQ	Channel:UC5WNBHwgluAwWJE5QV-5_TA
Olympus - Tweek (Cloud) vs Salem (Bayonetta) - SSB4 Winners Finals - Smash Wii U	Video:jWeIR2qpSeU	Channel:UC5WNBHwgluAwWJE5QV-5_TA
Olympus - Lunchables (Roy) vs Gallo (Mario) - PM Losers Finals - Project M	Video:dVKPZCwhkrk	Channel:UC5WNBHwgluAwWJE5QV-5_TA
Olympus - Larry Lurr (Fox) vs Fatality (Captain Falcon) - SSB4 Losers Quarters - Smash Wii U	Video:v1TTLHVYlN0	Channel:UC5WNBHwgluAwWJE5QV-5_TA
Olympus - Sosa (Wario) vs Gallo (Mario) - PM Losers Semis - Project M	Video:3ikxcWAiLfU	Channel:UC5WNBHwgluAwWJE5QV-5_TA
Olympus - Lunchables (Toon Link/Marth) vs ThundeRzReiGN (DK) - PM Winners Finals - Project M	Video:rsytp3HrYnY	Channel:UC5WNBHwgluAwWJE5QV-5_TA
Olympus - Anti (Mario/Cloud) vs Dakpo (Luigi/Diddy Kong) - SSB4 Losers Quarters - Smash Wii U	Video:K_SvJJbqxyI	Channel:UC5WNBHwgluAwWJE5QV-5_TA
Olympus - Junebug (Diddy Kong/Ganondorf) vs Gallo (Mario) - PM Losers Quarters - Project M	Video:CQ9bAEm0D_Y	Channel:UC5WNBHwgluAwWJE5QV-5_TA
Olympus - Sosa (Wario) vs Malachi (Peach) - PM Losers Quarters - Project M	Video:b1j79MmKzCo	Channel:UC5WNBHwgluAwWJE5QV-5_TA
Olympus - Salem (Bayonetta) vs Larry Lurr (Fox) - SSB4 Winners Semis - Smash Wii U	Video:ACHGNmbdKbQ	Channel:UC5WNBHwgluAwWJE5QV-5_TA
Olympus - ThundeRzReiGN (Donkey Kong) vs Junebug (Diddy Kong) - PM Winners Semis - Project M	Video:VuvlJNRFirc	Channel:UC5WNBHwgluAwWJE5QV-5_TA
Olympus - Anti (Mario) vs Tweek (Cloud) - SSB4 Winners Semis - Smash Wii U	Video:_A8atTk8Flo	Channel:UC5WNBHwgluAwWJE5QV-5_TA
Olympus - Lunchables (Toon Link) vs Sosa (Wario) - PM Winners Semis - Project M	Video:gs_53nGnv_0	Channel:UC5WNBHwgluAwWJE5QV-5_TA
Olympus - Frozen (Corrin) vs Fatality (Captain Falcon) - SSB4 Losers  Top 8 - Smash Wii U	Video:7PfooSqo0Zo	Channel:UC5WNBHwgluAwWJE5QV-5_TA
Olympus - Gallo (Mario) vs Jose V (Ness) - PM Losers Top 8 - Project M	Video:tvfSlNeQYLk	Channel:UC5WNBHwgluAwWJE5QV-5_TA
Olympus - Malachi (Sheik) vs Jaden (Peach/Sheik) - PM Losers Top 8 - Project M	Video:G1mbDrLjjro	Channel:UC5WNBHwgluAwWJE5QV-5_TA
Olympus - Dakpo (Diddy Kong) vs Vivid (Corrin) - SSB4 Losers Top 8 - Smash Wii U	Video:u7fUhbb_VUM	Channel:UC5WNBHwgluAwWJE5QV-5_TA
--------------------------------2017-03-16 01:29:23.275000
